본부명,지사명,단속장소,교통량,단속건수,과적,불법개조,연도
강원본부,강릉지사,강릉영업소,688,164,162,2,2022
강원본부,강릉지사,근덕영업소,243,133,90,43,2022
강원본부,강릉지사,남강릉영업소,96,32,28,4,2022
강원본부,강릉지사,남양양영업소,170,63,50,13,2022
강원본부,강릉지사,동해영업소,145,75,53,22,2022
강원본부,강릉지사,망상영업소,58,16,16,0,2022
강원본부,강릉지사,북강릉영업소,55,13,13,0,2022
강원본부,강릉지사,삼척영업소,52,32,19,13,2022
강원본부,강릉지사,옥계영업소,151,57,43,14,2022
강원본부,대관령지사,대관령영업소,64,8,4,4,2022
강원본부,대관령지사,대관령지사 교통안전팀,750,214,214,0,2022
강원본부,대관령지사,면온영업소,10,3,3,0,2022
강원본부,대관령지사,속사영업소,57,18,14,4,2022
강원본부,대관령지사,진부영업소,81,25,22,3,2022
강원본부,대관령지사,평창영업소,90,60,36,24,2022
강원본부,양양지사,내촌영업소,78,26,26,0,2022
강원본부,양양지사,북양양영업소,98,30,29,1,2022
강원본부,양양지사,서양양영업소,18,6,6,0,2022
강원본부,양양지사,속초영업소,217,75,71,4,2022
강원본부,양양지사,양양영업소,89,39,31,8,2022
강원본부,양양지사,인제영업소,81,27,27,0,2022
강원본부,양양지사,하조대영업소,138,70,52,18,2022
강원본부,원주지사,둔내영업소,72,16,16,0,2022
강원본부,원주지사,문막영업소,512,164,160,4,2022
강원본부,원주지사,새말영업소,140,40,38,2,2022
강원본부,원주지사,여주영업소,594,193,192,1,2022
강원본부,원주지사,원주영업소,1162,362,362,0,2022
강원본부,이천지사,남여주영업소,340,112,100,12,2022
강원본부,이천지사,덕평영업소,605,228,199,29,2022
강원본부,이천지사,북여주영업소,267,93,83,10,2022
강원본부,이천지사,서여주영업소,151,46,42,4,2022
강원본부,이천지사,양지영업소,1016,299,271,28,2022
강원본부,이천지사,양평영업소,200,72,68,4,2022
강원본부,이천지사,용인영업소,772,295,248,47,2022
강원본부,이천지사,이천영업소,368,124,122,2,2022
강원본부,춘천지사,강촌영업소,58,19,19,0,2022
강원본부,춘천지사,남양주영업소,407,141,133,8,2022
강원본부,춘천지사,남춘천영업소,45,15,14,1,2022
강원본부,춘천지사,덕소삼패영업소,237,83,80,3,2022
강원본부,춘천지사,동홍천영업소,105,36,35,1,2022
강원본부,춘천지사,서종영업소,29,11,10,1,2022
강원본부,춘천지사,설악영업소,279,93,93,0,2022
강원본부,춘천지사,조양영업소,34,11,11,0,2022
강원본부,춘천지사,화도영업소,358,122,120,2,2022
강원본부,홍천지사,북원주영업소,56,13,12,1,2022
강원본부,홍천지사,춘천영업소,328,84,77,7,2022
강원본부,홍천지사,홍천영업소,189,59,56,3,2022
강원본부,홍천지사,횡성영업소,359,135,111,24,2022
광주전남본부,광주전남본부 기술처,광주전남본부 교통팀,167,61,56,5,2022
광주전남본부,광주지사,광주영업소,2427,792,779,13,2022
광주전남본부,광주지사,담양영업소,563,186,185,1,2022
광주전남본부,광주지사,동광주영업소,1729,555,541,14,2022
광주전남본부,광주지사,백양사영업소,764,257,255,2,2022
광주전남본부,광주지사,장성영업소,1406,466,463,3,2022
광주전남본부,광주지사,창평영업소,353,115,115,0,2022
광주전남본부,구례지사,구례화엄사영업소,258,90,87,3,2022
광주전남본부,구례지사,동순천영업소,719,241,239,2,2022
광주전남본부,구례지사,북남원영업소,135,49,45,4,2022
광주전남본부,구례지사,서남원영업소,195,89,71,18,2022
광주전남본부,구례지사,오수영업소,381,159,134,25,2022
광주전남본부,구례지사,임실영업소,113,35,35,0,2022
광주전남본부,구례지사,황전영업소,149,51,49,2,2022
광주전남본부,남원지사,남원영업소,303,101,100,1,2022
광주전남본부,남원지사,동남원영업소,21,11,8,3,2022
광주전남본부,남원지사,순창영업소,229,79,75,4,2022
광주전남본부,남원지사,지리산영업소,40,12,11,1,2022
광주전남본부,담양지사,곡성영업소,445,155,144,11,2022
광주전남본부,담양지사,남고창영업소,621,211,207,4,2022
광주전남본부,담양지사,북광주영업소,1356,448,448,0,2022
광주전남본부,담양지사,옥과영업소,682,235,225,10,2022
광주전남본부,담양지사,장성물류영업소,212,61,61,0,2022
광주전남본부,보성지사,강진무위사영업소,742,239,238,1,2022
광주전남본부,보성지사,보성지사 고흥영업소,906,299,298,1,2022
광주전남본부,보성지사,보성지사 남순천영업소,1649,527,524,3,2022
광주전남본부,보성지사,보성지사 벌교영업소,938,314,309,5,2022
광주전남본부,보성지사,보성지사 보성영업소,1158,378,378,0,2022
광주전남본부,보성지사,서영암영업소,850,269,269,0,2022
광주전남본부,보성지사,순천만영업소,661,175,174,1,2022
광주전남본부,보성지사,장흥영업소,322,106,106,0,2022
광주전남본부,순천지사,광양영업소,750,265,249,16,2022
광주전남본부,순천지사,동광양영업소,505,167,163,4,2022
광주전남본부,순천지사,서순천영업소,291,104,97,7,2022
광주전남본부,순천지사,석곡영업소,27,9,9,0,2022
광주전남본부,순천지사,송광사영업소,201,67,67,0,2022
광주전남본부,순천지사,순천영업소,475,174,159,15,2022
광주전남본부,순천지사,승주영업소,154,54,52,2,2022
광주전남본부,순천지사,옥곡영업소,503,184,171,13,2022
광주전남본부,순천지사,진월영업소,1560,542,524,18,2022
광주전남본부,함평지사,나주영업소,679,225,222,3,2022
광주전남본부,함평지사,동광산영업소,6039,2008,1974,34,2022
광주전남본부,함평지사,동함평영업소,938,316,312,4,2022
광주전남본부,함평지사,목포영업소,4415,1443,1432,11,2022
광주전남본부,함평지사,무안공항영업소,727,239,238,1,2022
광주전남본부,함평지사,무안영업소,662,220,216,4,2022
광주전남본부,함평지사,문평영업소,748,277,256,21,2022
광주전남본부,함평지사,서광산영업소,1406,459,459,0,2022
광주전남본부,함평지사,영광영업소,687,221,219,2,2022
광주전남본부,함평지사,함평영업소,440,145,145,0,2022
대구경북본부,고령지사,가조영업소,132,41,41,0,2022
대구경북본부,고령지사,거창영업소,276,107,87,20,2022
대구경북본부,고령지사,고령영업소,635,228,203,25,2022
대구경북본부,고령지사,동고령영업소,747,290,243,47,2022
대구경북본부,고령지사,함양영업소,187,62,61,1,2022
대구경북본부,고령지사,해인사영업소,267,100,90,10,2022
대구경북본부,구미지사,구미영업소,369,115,115,0,2022
대구경북본부,구미지사,김천영업소,337,115,110,5,2022
대구경북본부,구미지사,남구미영업소,780,239,238,1,2022
대구경북본부,구미지사,동김천영업소,441,175,144,31,2022
대구경북본부,구미지사,왜관영업소,2394,859,791,68,2022
대구경북본부,구미지사,추풍령영업소,85,28,28,0,2022
대구경북본부,구미지사,칠곡물류영업소,510,169,156,13,2022
대구경북본부,군위지사,가산영업소,682,217,205,12,2022
대구경북본부,군위지사,군위영업소,213,59,52,7,2022
대구경북본부,군위지사,남대구영업소,1394,581,401,180,2022
대구경북본부,군위지사,다부영업소,378,127,105,22,2022
대구경북본부,군위지사,서대구영업소,1711,587,527,60,2022
대구경북본부,군위지사,의성영업소,257,75,74,1,2022
대구경북본부,군위지사,칠곡영업소,495,197,165,32,2022
대구경북본부,군위지사,화원옥포영업소,630,215,192,23,2022
대구경북본부,대구경북본부 관리처,대구경북본부 영업팀,2,2,1,1,2022
대구경북본부,대구경북본부 기술처,대구경북본부 교통팀,102,38,34,4,2022
대구경북본부,대구지사,건천영업소,841,301,270,31,2022
대구경북본부,대구지사,경산영업소,835,210,208,2,2022
대구경북본부,대구지사,경주영업소,1074,342,322,20,2022
대구경북본부,대구지사,대구지사 남칠곡영업소,1257,23,22,1,2022
대구경북본부,대구지사,대구지사 다사영업소,3,1,1,0,2022
대구경북본부,대구지사,대구지사 동명동호영업소,158,2,2,0,2022
대구경북본부,대구지사,대구지사 둔산영업소,58,16,16,0,2022
대구경북본부,대구지사,대구지사 북다사영업소,182,54,50,4,2022
대구경북본부,대구지사,대구지사 북달성영업소,344,16,14,2,2022
대구경북본부,대구지사,대구지사 연경영업소,344,41,38,3,2022
대구경북본부,대구지사,대구지사 율암영업소,96,24,24,0,2022
대구경북본부,대구지사,대구지사 지천영업소,81,19,15,4,2022
대구경북본부,대구지사,대구지사 파군재영업소,99,27,26,1,2022
대구경북본부,대구지사,북대구영업소,696,355,247,108,2022
대구경북본부,대구지사,영천영업소,436,140,137,3,2022
대구경북본부,성주지사,남김천영업소,372,166,124,42,2022
대구경북본부,성주지사,남성주영업소,287,101,90,11,2022
대구경북본부,성주지사,선산영업소,276,92,89,3,2022
대구경북본부,성주지사,성주영업소,428,164,129,35,2022
대구경북본부,성주지사,성주지사 교통안전팀,112,12,12,0,2022
대구경북본부,영주지사,남안동영업소,394,106,104,2,2022
대구경북본부,영주지사,서안동영업소,319,97,94,3,2022
대구경북본부,영주지사,영주영업소,445,138,130,8,2022
대구경북본부,영주지사,영주지사 교통안전팀,678,226,226,0,2022
대구경북본부,영주지사,예천영업소,56,20,18,2,2022
대구경북본부,영주지사,풍기영업소,302,89,85,4,2022
대구경북본부,영천지사,북영천영업소,313,99,96,3,2022
대구경북본부,영천지사,서포항영업소,487,180,151,29,2022
대구경북본부,영천지사,청통와촌영업소,437,128,124,4,2022
대구경북본부,영천지사,팔공산영업소,616,201,182,19,2022
대구경북본부,영천지사,포항영업소,896,266,250,16,2022
대구경북본부,청송지사,청송지사 동상주영업소,147,63,48,15,2022
대구경북본부,청송지사,청송지사 동안동영업소,319,137,109,28,2022
대구경북본부,청송지사,청송지사 동청송영양영업소,140,53,43,10,2022
대구경북본부,청송지사,청송지사 북의성영업소,229,71,71,0,2022
대구경북본부,청송지사,청송지사 서의성영업소,217,71,66,5,2022
대구경북본부,청송지사,청송지사 영덕영업소,765,273,244,29,2022
대구경북본부,청송지사,청송지사 청송영업소,174,62,53,9,2022
대전충남본부,공주지사,공주영업소,375,122,120,2,2022
대전충남본부,공주지사,남세종영업소,810,225,207,18,2022
대전충남본부,공주지사,마곡사영업소,171,52,51,1,2022
대전충남본부,공주지사,서세종영업소,664,220,218,2,2022
대전충남본부,공주지사,신양영업소,202,61,61,0,2022
대전충남본부,공주지사,예산영업소,659,197,197,0,2022
대전충남본부,공주지사,유구영업소,177,52,52,0,2022
대전충남본부,당진지사,고덕영업소,330,96,96,0,2022
대전충남본부,당진지사,당진영업소,1360,419,408,11,2022
대전충남본부,당진지사,면천영업소,350,103,99,4,2022
대전충남본부,당진지사,서산영업소,2637,750,750,0,2022
대전충남본부,당진지사,송악영업소,3047,878,873,5,2022
대전충남본부,당진지사,해미영업소,510,142,136,6,2022
대전충남본부,당진지사,홍성영업소,964,270,270,0,2022
대전충남본부,대전지사,남청주영업소,819,264,258,6,2022
대전충남본부,대전지사,대전영업소,955,290,275,15,2022
대전충남본부,대전지사,북대전영업소,1449,453,450,3,2022
대전충남본부,대전지사,신탄진영업소,994,309,303,6,2022
대전충남본부,대전지사,유성영업소,1542,448,435,13,2022
대전충남본부,부여지사,동서천영업소,543,169,169,0,2022
대전충남본부,부여지사,부여영업소,176,60,57,3,2022
대전충남본부,부여지사,서공주영업소,237,71,71,0,2022
대전충남본부,부여지사,서부여영업소,301,99,99,0,2022
대전충남본부,부여지사,청양영업소,111,27,27,0,2022
대전충남본부,영동지사,금강영업소,166,55,55,0,2022
대전충남본부,영동지사,서대전영업소,1941,629,621,8,2022
대전충남본부,영동지사,안영영업소,244,97,78,19,2022
대전충남본부,영동지사,영동영업소,273,90,89,1,2022
대전충남본부,영동지사,옥천영업소,524,159,159,0,2022
대전충남본부,영동지사,판암영업소,591,188,174,14,2022
대전충남본부,영동지사,황간영업소,259,81,80,1,2022
대전충남본부,천안지사,목천영업소,1608,515,507,8,2022
대전충남본부,천안지사,북천안영업소,1268,396,377,19,2022
대전충남본부,천안지사,안성영업소,819,256,255,1,2022
대전충남본부,천안지사,천안영업소,3787,1173,1170,3,2022
대전충남본부,천안지사,청주영업소,793,243,239,4,2022
부산경남본부,경주지사,경주지사 교통안전팀,848,280,280,0,2022
부산경남본부,경주지사,남경주영업소,621,170,166,4,2022
부산경남본부,경주지사,남포항영업소,1597,485,459,26,2022
부산경남본부,경주지사,동경주영업소,394,157,135,22,2022
부산경남본부,경주지사,범서영업소,344,99,93,6,2022
부산경남본부,고성지사,고성영업소,967,311,306,5,2022
부산경남본부,고성지사,동고성영업소,822,257,256,1,2022
부산경남본부,고성지사,북통영영업소,647,210,210,0,2022
부산경남본부,고성지사,연화산영업소,260,78,78,0,2022
부산경남본부,고성지사,통영영업소,660,206,204,2,2022
부산경남본부,부산경남본부 기술처,부산경남본부 교통팀,114,38,38,0,2022
부산경남본부,산청지사,단성영업소,943,306,303,3,2022
부산경남본부,산청지사,산청영업소,299,99,93,6,2022
부산경남본부,산청지사,생초영업소,533,171,170,1,2022
부산경남본부,산청지사,서상영업소,667,197,196,1,2022
부산경남본부,산청지사,서진주영업소,996,321,316,5,2022
부산경남본부,산청지사,지곡영업소,1236,403,403,0,2022
부산경남본부,서울산지사,노포영업소,1074,288,287,1,2022
부산경남본부,서울산지사,부산영업소,3536,1055,993,62,2022
부산경남본부,서울산지사,서울산영업소,1185,331,324,7,2022
부산경남본부,서울산지사,서울산지사 교통안전팀,1095,281,281,0,2022
부산경남본부,서울산지사,서울산지사 배내골영업소,427,139,139,0,2022
부산경남본부,서울산지사,양산영업소,2150,568,565,3,2022
부산경남본부,서울산지사,통도사영업소,646,173,170,3,2022
부산경남본부,서울산지사,활천영업소,624,203,194,9,2022
부산경남본부,양산지사,광재영업소,938,265,258,7,2022
부산경남본부,양산지사,남양산영업소,1473,436,419,17,2022
부산경남본부,양산지사,대동영업소,5189,1835,1541,294,2022
부산경남본부,양산지사,동김해영업소,660,202,194,8,2022
부산경남본부,양산지사,물금영업소,1115,339,334,5,2022
부산경남본부,양산지사,북부산영업소,2092,600,570,30,2022
부산경남본부,양산지사,서김해영업소,652,191,188,3,2022
부산경남본부,양산지사,양산지사 교통안전팀,3014,1010,1006,4,2022
부산경남본부,양산지사,양산지사 한림영업소,244,66,64,2,2022
부산경남본부,양산지사,진영영업소,1511,411,401,10,2022
부산경남본부,울산지사,금정영업소,545,161,159,2,2022
부산경남본부,울산지사,기장일광영업소,1147,388,369,19,2022
부산경남본부,울산지사,기장일광영업소(재정),20,0,0,0,2022
부산경남본부,울산지사,기장철마영업소,1156,365,358,7,2022
부산경남본부,울산지사,동부산영업소,504,149,138,11,2022
부산경남본부,울산지사,문수영업소,494,163,150,13,2022
부산경남본부,울산지사,온양영업소,326,104,97,7,2022
부산경남본부,울산지사,울산영업소,2153,723,616,107,2022
부산경남본부,울산지사,울산지사 교통안전팀,5005,603,603,0,2022
부산경남본부,울산지사,장안영업소,502,179,153,26,2022
부산경남본부,울산지사,청량영업소,3242,1032,988,44,2022
부산경남본부,울산지사,해운대송정영업소,2046,665,608,57,2022
부산경남본부,진주지사,곤양영업소,1227,407,404,3,2022
부산경남본부,진주지사,군북영업소,2045,653,652,1,2022
부산경남본부,진주지사,문산영업소,535,169,168,1,2022
부산경남본부,진주지사,사천영업소,5215,1689,1684,5,2022
부산경남본부,진주지사,장지영업소,1869,596,595,1,2022
부산경남본부,진주지사,지수영업소,486,150,150,0,2022
부산경남본부,진주지사,진교영업소,759,246,246,0,2022
부산경남본부,진주지사,진성영업소,846,271,270,1,2022
부산경남본부,진주지사,진주영업소,3842,1242,1236,6,2022
부산경남본부,진주지사,축동영업소,810,261,261,0,2022
부산경남본부,진주지사,하동영업소,1358,460,449,11,2022
부산경남본부,진주지사,함안영업소,2677,887,880,7,2022
부산경남본부,창녕지사,남지영업소,368,124,119,5,2022
부산경남본부,창녕지사,내서영업소,673,223,223,0,2022
부산경남본부,창녕지사,달성영업소,398,120,120,0,2022
부산경남본부,창녕지사,영산영업소,597,181,181,0,2022
부산경남본부,창녕지사,창녕영업소,1161,373,373,0,2022
부산경남본부,창녕지사,칠서영업소,1360,424,415,9,2022
부산경남본부,창녕지사,칠원영업소,1589,487,451,36,2022
부산경남본부,창녕지사,현풍영업소,1445,398,397,1,2022
부산경남본부,창원지사,가락영업소,1897,506,495,11,2022
부산경남본부,창원지사,동창원영업소,742,197,184,13,2022
부산경남본부,창원지사,마산영업소,2500,576,575,1,2022
부산경남본부,창원지사,북창원영업소,1412,454,436,18,2022
부산경남본부,창원지사,산인영업소,4597,1419,1390,29,2022
부산경남본부,창원지사,서부산영업소,2209,741,705,36,2022
부산경남본부,창원지사,장유영업소,4096,1310,1287,23,2022
부산경남본부,창원지사,진례영업소,1953,603,594,9,2022
부산경남본부,창원지사,창원지사 교통안전팀,2913,971,971,0,2022
수도권본부,경기광주지사,경기광주영업소,450,158,147,11,2022
수도권본부,경기광주지사,곤지암영업소,232,86,78,8,2022
수도권본부,경기광주지사,동서울영업소,3155,1172,914,258,2022
수도권본부,경기광주지사,서이천영업소,349,111,103,8,2022
수도권본부,경기광주지사,하남영업소,513,220,173,47,2022
수도권본부,군포지사,군자영업소,6815,2291,2184,107,2022
수도권본부,군포지사,군포영업소,160,56,50,6,2022
수도권본부,군포지사,군포지사 교통안전팀,544,136,136,0,2022
수도권본부,군포지사,동군포영업소,128,44,42,2,2022
수도권본부,군포지사,동수원영업소,347,99,91,8,2022
수도권본부,군포지사,마성영업소,54,26,20,6,2022
수도권본부,군포지사,부곡영업소,714,235,234,1,2022
수도권본부,군포지사,북수원영업소,293,139,108,31,2022
수도권본부,군포지사,서안산영업소,600,193,187,6,2022
수도권본부,군포지사,안산영업소,507,89,84,5,2022
수도권본부,동서울지사,구리남양주영업소,5552,802,703,99,2022
수도권본부,동서울지사,성남영업소,3683,774,709,65,2022
수도권본부,동서울지사,청계영업소,3844,853,833,20,2022
수도권본부,동서울지사,토평영업소,248,88,84,4,2022
수도권본부,수도권본부 기술처,수도권본부 교통팀,134,36,36,0,2022
수도권본부,수원지사,기흥동탄영업소,821,234,228,6,2022
수도권본부,수원지사,기흥영업소,1318,412,406,6,2022
수도권본부,수원지사,남사진위영업소,227,41,38,3,2022
수도권본부,수원지사,서울영업소,7890,2239,2229,10,2022
수도권본부,수원지사,수원신갈영업소,1508,352,338,14,2022
수도권본부,수원지사,오산영업소,1153,344,340,4,2022
수도권본부,수원지사,판교영업소,160,85,60,25,2022
수도권본부,시흥지사,남인천영업소,3842,1291,1142,149,2022
수도권본부,시흥지사,서서울영업소,2383,1453,927,526,2022
수도권본부,시흥지사,시흥영업소,4545,1251,1214,37,2022
수도권본부,인천지사,김포영업소,8116,2704,2430,274,2022
수도권본부,인천지사,인천영업소,4299,1926,1445,481,2022
수도권본부,인천지사,인천지사 교통안전팀,3665,1219,1219,0,2022
수도권본부,화성지사,남안성영업소,3526,1130,1125,5,2022
수도권본부,화성지사,매송영업소,123,47,41,6,2022
수도권본부,화성지사,발안영업소,1231,385,384,1,2022
수도권본부,화성지사,비봉영업소,393,132,123,9,2022
수도권본부,화성지사,서안성영업소,2486,803,802,1,2022
수도권본부,화성지사,서평택영업소,3928,1129,1078,51,2022
수도권본부,화성지사,송탄영업소,859,249,233,16,2022
수도권본부,화성지사,청북영업소,1641,476,462,14,2022
수도권본부,화성지사,평택고덕영업소,883,277,269,8,2022
수도권본부,화성지사,평택영업소,3581,1064,1022,42,2022
전북본부,논산지사,계룡영업소,318,102,102,0,2022
전북본부,논산지사,논산영업소,418,132,132,0,2022
전북본부,논산지사,완주영업소,809,243,242,1,2022
전북본부,논산지사,익산영업소,678,206,202,4,2022
전북본부,무주지사,금산영업소,502,157,156,1,2022
전북본부,무주지사,남대전영업소,695,204,198,6,2022
전북본부,무주지사,덕유산영업소,91,30,30,0,2022
전북본부,무주지사,무주영업소,383,113,112,1,2022
전북본부,무주지사,추부영업소,331,95,92,3,2022
전북본부,보령지사,광천영업소,562,168,167,1,2022
전북본부,보령지사,군산영업소,338,90,90,0,2022
전북본부,보령지사,대천영업소,393,111,111,0,2022
전북본부,보령지사,무창포영업소,249,75,75,0,2022
전북본부,보령지사,서천영업소,531,169,169,0,2022
전북본부,보령지사,춘장대영업소,83,26,26,0,2022
전북본부,부안지사,고창영업소,448,139,139,0,2022
전북본부,부안지사,동군산영업소,560,170,169,1,2022
전북본부,부안지사,부안영업소,198,63,63,0,2022
전북본부,부안지사,서김제영업소,312,97,97,0,2022
전북본부,부안지사,선운산영업소,479,157,150,7,2022
전북본부,부안지사,줄포영업소,158,47,47,0,2022
전북본부,전주지사,금산사영업소,212,73,71,2,2022
전북본부,전주지사,김제영업소,548,165,164,1,2022
전북본부,전주지사,내장산영업소,236,66,66,0,2022
전북본부,전주지사,삼례영업소,347,113,112,1,2022
전북본부,전주지사,서전주영업소,429,132,132,0,2022
전북본부,전주지사,전주영업소,611,181,181,0,2022
전북본부,전주지사,전주지사 교통안전팀,3,1,1,0,2022
전북본부,전주지사,정읍영업소,283,85,84,1,2022
전북본부,전주지사,태인영업소,360,59,59,0,2022
전북본부,진안지사,동전주영업소,315,97,97,0,2022
전북본부,진안지사,상관영업소,339,105,105,0,2022
전북본부,진안지사,소양영업소,631,206,205,1,2022
전북본부,진안지사,장수영업소,145,34,34,0,2022
전북본부,진안지사,진안영업소,162,54,53,1,2022
지역본부,강원본부,대관령지사,3,1,1,0,2022
지역본부,강원본부,이천지사,3,1,1,0,2022
지역본부,광주전남본부,광주지사,3,1,1,0,2022
지역본부,광주전남본부,담양지사,9,3,3,0,2022
지역본부,대구경북본부,군위지사,15,5,5,0,2022
지역본부,대구경북본부,대구지사,6,2,1,1,2022
지역본부,대구경북본부,성주지사,3,1,1,0,2022
지역본부,대전충남본부,당진지사,5,3,2,1,2022
지역본부,대전충남본부,영동지사,3,1,1,0,2022
지역본부,부산경남본부,경주지사,6,2,2,0,2022
지역본부,부산경남본부,서울산지사,3,1,1,0,2022
지역본부,부산경남본부,울산지사,4,1,1,0,2022
지역본부,수도권본부,시흥지사,3,1,1,0,2022
지역본부,수도권본부,화성지사,3,1,1,0,2022
지역본부,전북본부,전주지사,12,0,0,0,2022
지역본부,전북본부,진안지사,4,0,0,0,2022
충북본부,보은지사,남상주영업소,233,64,64,0,2022
충북본부,보은지사,보은영업소,62,19,19,0,2022
충북본부,보은지사,보은지사 문의청남대영업소,246,77,74,3,2022
충북본부,보은지사,속리산영업소,111,33,31,2,2022
충북본부,보은지사,화서영업소,75,18,18,0,2022
충북본부,보은지사,회인영업소,165,55,55,0,2022
충북본부,상주지사,문경새재영업소,407,112,111,1,2022
충북본부,상주지사,북상주영업소,377,106,106,0,2022
충북본부,상주지사,상주영업소,204,62,61,1,2022
충북본부,상주지사,상주지사 고객지원팀,3,1,1,0,2022
충북본부,상주지사,점촌함창영업소,279,82,79,3,2022
충북본부,엄정지사,금왕꽃동네영업소,320,128,106,22,2022
충북본부,엄정지사,동충주영업소,807,266,263,3,2022
충북본부,엄정지사,북진천영업소,434,116,114,2,2022
충북본부,엄정지사,서충주영업소,458,154,151,3,2022
충북본부,엄정지사,엄정지사 교통안전팀,27,9,9,0,2022
충북본부,엄정지사,음성영업소,377,119,112,7,2022
충북본부,제천지사,남원주영업소,1260,416,410,6,2022
충북본부,제천지사,남제천영업소,965,291,259,32,2022
충북본부,제천지사,단양영업소,191,54,51,3,2022
충북본부,제천지사,북단양영업소,376,107,101,6,2022
충북본부,제천지사,신림영업소,634,238,215,23,2022
충북본부,제천지사,제천영업소,1049,343,332,11,2022
충북본부,제천지사,제천지사 교통안전팀,582,194,194,0,2022
충북본부,진천지사,남이천영업소,339,123,111,12,2022
충북본부,진천지사,대소영업소,356,113,113,0,2022
충북본부,진천지사,서청주영업소,982,263,262,1,2022
충북본부,진천지사,오창영업소,672,176,175,1,2022
충북본부,진천지사,일죽영업소,301,78,77,1,2022
충북본부,진천지사,증평영업소,219,65,64,1,2022
충북본부,진천지사,진천영업소,321,92,92,0,2022
충북본부,진천지사,진천지사 교통안전팀,3246,1138,1096,42,2022
충북본부,충주지사,감곡영업소,154,43,42,1,2022
충북본부,충주지사,괴산영업소,247,66,66,0,2022
충북본부,충주지사,북충주영업소,199,53,51,2,2022
충북본부,충주지사,연풍영업소,368,94,92,2,2022
충북본부,충주지사,충주영업소,178,48,46,2,2022
강원본부,강릉지사,강릉영업소,310,91,90,1,2021
강원본부,강릉지사,근덕영업소,438,177,138,39,2021
강원본부,강릉지사,남강릉영업소,126,33,32,1,2021
강원본부,강릉지사,남양양영업소,49,31,19,12,2021
강원본부,강릉지사,동해영업소,464,209,155,54,2021
강원본부,강릉지사,망상영업소,40,14,13,1,2021
강원본부,강릉지사,북강릉영업소,44,16,14,2,2021
강원본부,강릉지사,삼척영업소,102,58,39,19,2021
강원본부,강릉지사,옥계영업소,160,44,43,1,2021
강원본부,대관령지사,대관령영업소,183,47,47,0,2021
강원본부,대관령지사,대관령지사 교통안전팀,642,178,177,1,2021
강원본부,대관령지사,면온영업소,173,43,43,0,2021
강원본부,대관령지사,속사영업소,96,37,28,9,2021
강원본부,대관령지사,진부영업소,97,33,29,4,2021
강원본부,대관령지사,평창영업소,278,106,86,20,2021
강원본부,양양지사,내촌영업소,38,14,13,1,2021
강원본부,양양지사,북양양영업소,108,31,31,0,2021
강원본부,양양지사,서양양영업소,35,13,12,1,2021
강원본부,양양지사,속초영업소,173,59,58,1,2021
강원본부,양양지사,양양영업소,224,94,76,18,2021
강원본부,양양지사,인제영업소,214,74,72,2,2021
강원본부,양양지사,하조대영업소,79,25,25,0,2021
강원본부,원주지사,둔내영업소,31,7,7,0,2021
강원본부,원주지사,문막영업소,481,171,158,13,2021
강원본부,원주지사,새말영업소,90,30,29,1,2021
강원본부,원주지사,여주영업소,158,53,47,6,2021
강원본부,원주지사,원주영업소,273,91,86,5,2021
강원본부,원주지사,원주지사 교통안전팀,675,169,169,0,2021
강원본부,이천지사,남여주영업소,145,47,44,3,2021
강원본부,이천지사,덕평영업소,439,165,149,16,2021
강원본부,이천지사,북여주영업소,118,68,45,23,2021
강원본부,이천지사,서여주영업소,36,16,13,3,2021
강원본부,이천지사,양지영업소,546,215,187,28,2021
강원본부,이천지사,양평영업소,116,48,41,7,2021
강원본부,이천지사,용인영업소,289,108,89,19,2021
강원본부,이천지사,이천영업소,264,87,86,1,2021
강원본부,이천지사,이천지사 교통안전팀,2887,722,722,0,2021
강원본부,춘천지사,강촌영업소,19,5,5,0,2021
강원본부,춘천지사,남양주영업소,66,22,21,1,2021
강원본부,춘천지사,남춘천영업소,3,1,1,0,2021
강원본부,춘천지사,덕소삼패영업소,209,179,97,82,2021
강원본부,춘천지사,동홍천영업소,53,11,11,0,2021
강원본부,춘천지사,서종영업소,9,3,3,0,2021
강원본부,춘천지사,설악영업소,21,7,7,0,2021
강원본부,춘천지사,조양영업소,8,1,1,0,2021
강원본부,춘천지사,춘천지사 고객지원팀,3,1,1,0,2021
강원본부,춘천지사,화도영업소,120,41,39,2,2021
강원본부,홍천지사,북원주영업소,66,22,21,1,2021
강원본부,홍천지사,춘천영업소,212,77,68,9,2021
강원본부,홍천지사,홍천영업소,294,75,72,3,2021
강원본부,홍천지사,횡성영업소,248,131,88,43,2021
광주전남본부,광주전남본부 기술처,광주전남본부 교통팀,339,91,90,1,2021
광주전남본부,광주지사,광주영업소,334,111,105,6,2021
광주전남본부,광주지사,광주지사 교통안전팀,1191,298,298,0,2021
광주전남본부,광주지사,담양영업소,65,19,19,0,2021
광주전남본부,광주지사,동광주영업소,291,84,82,2,2021
광주전남본부,광주지사,백양사영업소,47,13,13,0,2021
광주전남본부,광주지사,장성영업소,172,44,44,0,2021
광주전남본부,광주지사,창평영업소,61,20,20,0,2021
광주전남본부,구례지사,구례화엄사영업소,227,91,68,23,2021
광주전남본부,구례지사,동순천영업소,471,138,134,4,2021
광주전남본부,구례지사,북남원영업소,158,63,47,16,2021
광주전남본부,구례지사,서남원영업소,148,49,42,7,2021
광주전남본부,구례지사,오수영업소,184,59,48,11,2021
광주전남본부,구례지사,임실영업소,139,37,37,0,2021
광주전남본부,구례지사,황전영업소,154,43,42,1,2021
광주전남본부,남원지사,남원영업소,141,41,39,2,2021
광주전남본부,남원지사,남원지사 교통안전팀,52,13,13,0,2021
광주전남본부,남원지사,동남원영업소,184,46,46,0,2021
광주전남본부,남원지사,순창영업소,477,128,125,3,2021
광주전남본부,남원지사,지리산영업소,431,110,110,0,2021
광주전남본부,담양지사,곡성영업소,91,29,27,2,2021
광주전남본부,담양지사,남고창영업소,127,65,45,20,2021
광주전남본부,담양지사,담양지사 교통안전팀,604,151,151,0,2021
광주전남본부,담양지사,북광주영업소,227,60,60,0,2021
광주전남본부,담양지사,옥과영업소,329,101,90,11,2021
광주전남본부,담양지사,장성물류영업소,46,14,14,0,2021
광주전남본부,보성지사,강진무위사영업소,380,119,119,0,2021
광주전남본부,보성지사,보성지사 고흥영업소,365,118,118,0,2021
광주전남본부,보성지사,보성지사 남순천영업소,926,260,258,2,2021
광주전남본부,보성지사,보성지사 벌교영업소,291,86,86,0,2021
광주전남본부,보성지사,보성지사 보성영업소,137,44,44,0,2021
광주전남본부,보성지사,서영암영업소,273,85,84,1,2021
광주전남본부,보성지사,순천만영업소,381,123,122,1,2021
광주전남본부,보성지사,장흥영업소,198,66,66,0,2021
광주전남본부,순천지사,광양영업소,454,140,137,3,2021
광주전남본부,순천지사,동광양영업소,229,75,72,3,2021
광주전남본부,순천지사,서순천영업소,134,46,44,2,2021
광주전남본부,순천지사,석곡영업소,27,8,8,0,2021
광주전남본부,순천지사,송광사영업소,55,14,14,0,2021
광주전남본부,순천지사,순천영업소,298,104,92,12,2021
광주전남본부,순천지사,순천지사 교통안전팀,1147,287,287,0,2021
광주전남본부,순천지사,승주영업소,86,24,22,2,2021
광주전남본부,순천지사,옥곡영업소,221,95,79,16,2021
광주전남본부,순천지사,진월영업소,589,208,192,16,2021
광주전남본부,함평지사,나주영업소,326,90,86,4,2021
광주전남본부,함평지사,동광산영업소,374,113,104,9,2021
광주전남본부,함평지사,동함평영업소,355,125,103,22,2021
광주전남본부,함평지사,목포영업소,659,196,186,10,2021
광주전남본부,함평지사,무안공항영업소,257,68,68,0,2021
광주전남본부,함평지사,무안영업소,598,161,161,0,2021
광주전남본부,함평지사,문평영업소,3,1,1,0,2021
광주전남본부,함평지사,서광산영업소,159,69,56,13,2021
광주전남본부,함평지사,영광영업소,148,48,46,2,2021
광주전남본부,함평지사,함평영업소,29,7,7,0,2021
광주전남본부,함평지사,함평지사 교통안전팀,32,8,8,0,2021
대구경북본부,고령지사,가조영업소,127,40,40,0,2021
대구경북본부,고령지사,거창영업소,230,101,77,24,2021
대구경북본부,고령지사,고령영업소,257,91,77,14,2021
대구경북본부,고령지사,고령지사 교통안전팀,456,114,114,0,2021
대구경북본부,고령지사,동고령영업소,408,163,136,27,2021
대구경북본부,고령지사,함양영업소,145,51,47,4,2021
대구경북본부,고령지사,해인사영업소,76,27,24,3,2021
대구경북본부,구미지사,구미영업소,1069,342,327,15,2021
대구경북본부,구미지사,구미지사 교통안전팀,456,127,127,0,2021
대구경북본부,구미지사,김천영업소,317,85,85,0,2021
대구경북본부,구미지사,남구미영업소,625,194,185,9,2021
대구경북본부,구미지사,동김천영업소,251,96,74,22,2021
대구경북본부,구미지사,왜관영업소,1011,299,283,16,2021
대구경북본부,구미지사,추풍령영업소,134,38,38,0,2021
대구경북본부,구미지사,칠곡물류영업소,587,194,184,10,2021
대구경북본부,군위지사,가산영업소,752,254,224,30,2021
대구경북본부,군위지사,군위영업소,235,91,76,15,2021
대구경북본부,군위지사,군위지사 교통안전팀,1586,397,397,0,2021
대구경북본부,군위지사,남대구영업소,1422,611,465,146,2021
대구경북본부,군위지사,다부영업소,231,65,62,3,2021
대구경북본부,군위지사,서대구영업소,2551,824,787,37,2021
대구경북본부,군위지사,의성영업소,430,128,128,0,2021
대구경북본부,군위지사,칠곡영업소,543,237,182,55,2021
대구경북본부,군위지사,화원옥포영업소,1520,454,449,5,2021
대구경북본부,대구경북본부 기술처,대구경북본부 교통팀,15,5,5,0,2021
대구경북본부,대구지사,건천영업소,782,264,231,33,2021
대구경북본부,대구지사,경산영업소,1525,434,433,1,2021
대구경북본부,대구지사,경주영업소,1703,531,505,26,2021
대구경북본부,대구지사,대구지사 교통안전팀,177,59,59,0,2021
대구경북본부,대구지사,북대구영업소,2046,701,614,87,2021
대구경북본부,대구지사,영천영업소,940,262,260,2,2021
대구경북본부,성주지사,남김천영업소,411,230,145,85,2021
대구경북본부,성주지사,남성주영업소,247,70,69,1,2021
대구경북본부,성주지사,선산영업소,87,27,25,2,2021
대구경북본부,성주지사,성주영업소,171,66,58,8,2021
대구경북본부,성주지사,성주지사 교통안전팀,336,84,84,0,2021
대구경북본부,영주지사,남안동영업소,162,54,49,5,2021
대구경북본부,영주지사,서안동영업소,122,46,38,8,2021
대구경북본부,영주지사,영주영업소,345,122,106,16,2021
대구경북본부,영주지사,영주지사 교통안전팀,1651,481,481,0,2021
대구경북본부,영주지사,예천영업소,22,6,5,1,2021
대구경북본부,영주지사,풍기영업소,330,86,85,1,2021
대구경북본부,영천지사,북영천영업소,191,56,55,1,2021
대구경북본부,영천지사,서포항영업소,264,85,84,1,2021
대구경북본부,영천지사,청통와촌영업소,197,57,55,2,2021
대구경북본부,영천지사,팔공산영업소,481,152,137,15,2021
대구경북본부,영천지사,포항영업소,1152,405,372,33,2021
대구경북본부,청송지사,청송지사 동상주영업소,133,53,44,9,2021
대구경북본부,청송지사,청송지사 동안동영업소,141,59,46,13,2021
대구경북본부,청송지사,청송지사 동청송영양영업소,62,39,25,14,2021
대구경북본부,청송지사,청송지사 북의성영업소,71,26,24,2,2021
대구경북본부,청송지사,청송지사 서의성영업소,146,50,47,3,2021
대구경북본부,청송지사,청송지사 영덕영업소,141,68,51,17,2021
대구경북본부,청송지사,청송지사 청송영업소,82,28,26,2,2021
대전충남본부,공주지사,공주영업소,363,107,106,1,2021
대전충남본부,공주지사,남세종영업소,357,105,105,0,2021
대전충남본부,공주지사,마곡사영업소,133,38,37,1,2021
대전충남본부,공주지사,서세종영업소,506,151,149,2,2021
대전충남본부,공주지사,신양영업소,459,143,143,0,2021
대전충남본부,공주지사,예산영업소,610,171,168,3,2021
대전충남본부,공주지사,유구영업소,211,59,58,1,2021
대전충남본부,당진지사,고덕영업소,844,238,238,0,2021
대전충남본부,당진지사,당진영업소,1237,359,359,0,2021
대전충남본부,당진지사,면천영업소,995,287,278,9,2021
대전충남본부,당진지사,서산영업소,1213,355,353,2,2021
대전충남본부,당진지사,송악영업소,2201,639,632,7,2021
대전충남본부,당진지사,해미영업소,832,242,242,0,2021
대전충남본부,당진지사,홍성영업소,616,182,181,1,2021
대전충남본부,대전지사,남청주영업소,2286,582,578,4,2021
대전충남본부,대전지사,대전영업소,942,265,256,9,2021
대전충남본부,대전지사,대전지사 고객지원팀,4,0,0,0,2021
대전충남본부,대전지사,대전지사 교통안전팀,780,195,195,0,2021
대전충남본부,대전지사,북대전영업소,784,215,208,7,2021
대전충남본부,대전지사,신탄진영업소,1095,285,284,1,2021
대전충남본부,대전지사,유성영업소,942,261,257,4,2021
대전충남본부,대전충남본부 기술처,대전충남본부 교통팀,405,135,135,0,2021
대전충남본부,부여지사,동서천영업소,362,115,113,2,2021
대전충남본부,부여지사,부여영업소,192,50,50,0,2021
대전충남본부,부여지사,부여지사 교통안전팀,21,7,7,0,2021
대전충남본부,부여지사,서공주영업소,336,89,88,1,2021
대전충남본부,부여지사,서부여영업소,318,104,104,0,2021
대전충남본부,부여지사,청양영업소,107,30,30,0,2021
대전충남본부,영동지사,금강영업소,108,32,30,2,2021
대전충남본부,영동지사,서대전영업소,252,87,82,5,2021
대전충남본부,영동지사,안영영업소,212,75,63,12,2021
대전충남본부,영동지사,영동영업소,142,42,41,1,2021
대전충남본부,영동지사,옥천영업소,544,156,155,1,2021
대전충남본부,영동지사,판암영업소,218,77,65,12,2021
대전충남본부,영동지사,황간영업소,131,40,38,2,2021
대전충남본부,천안지사,목천영업소,551,165,157,8,2021
대전충남본부,천안지사,북천안영업소,776,259,245,14,2021
대전충남본부,천안지사,안성영업소,193,62,58,4,2021
대전충남본부,천안지사,천안영업소,595,180,180,0,2021
대전충남본부,천안지사,청주영업소,523,151,150,1,2021
부산경남본부,경주지사,남경주영업소,582,170,166,4,2021
부산경남본부,경주지사,남포항영업소,1518,497,448,49,2021
부산경남본부,경주지사,동경주영업소,183,69,61,8,2021
부산경남본부,경주지사,범서영업소,205,66,62,4,2021
부산경남본부,고성지사,고성영업소,464,140,133,7,2021
부산경남본부,고성지사,고성지사 교통안전팀,78,26,26,0,2021
부산경남본부,고성지사,동고성영업소,309,85,85,0,2021
부산경남본부,고성지사,북통영영업소,259,70,70,0,2021
부산경남본부,고성지사,연화산영업소,293,81,79,2,2021
부산경남본부,고성지사,통영영업소,632,184,184,0,2021
부산경남본부,부산경남본부 기술처,부산경남본부 교통팀,93,31,31,0,2021
부산경남본부,산청지사,단성영업소,759,207,201,6,2021
부산경남본부,산청지사,산청영업소,600,157,154,3,2021
부산경남본부,산청지사,산청지사 교통안전팀,1930,643,643,0,2021
부산경남본부,산청지사,생초영업소,480,219,152,67,2021
부산경남본부,산청지사,서상영업소,194,75,56,19,2021
부산경남본부,산청지사,서진주영업소,359,117,97,20,2021
부산경남본부,산청지사,지곡영업소,696,187,185,2,2021
부산경남본부,서울산지사,노포영업소,334,80,78,2,2021
부산경남본부,서울산지사,부산영업소,1798,591,517,74,2021
부산경남본부,서울산지사,서울산영업소,915,261,249,12,2021
부산경남본부,서울산지사,서울산지사 교통안전팀,6,2,2,0,2021
부산경남본부,서울산지사,양산영업소,849,250,239,11,2021
부산경남본부,서울산지사,통도사영업소,1009,271,266,5,2021
부산경남본부,서울산지사,활천영업소,554,150,148,2,2021
부산경남본부,양산지사,광재영업소,1254,428,412,16,2021
부산경남본부,양산지사,남양산영업소,1491,426,407,19,2021
부산경남본부,양산지사,대동영업소,5605,1827,1680,147,2021
부산경남본부,양산지사,동김해영업소,525,145,144,1,2021
부산경남본부,양산지사,물금영업소,594,178,175,3,2021
부산경남본부,양산지사,북부산영업소,1086,383,339,44,2021
부산경남본부,양산지사,서김해영업소,806,220,216,4,2021
부산경남본부,양산지사,양산지사 교통안전팀,888,296,296,0,2021
부산경남본부,양산지사,양산지사 한림영업소,26,6,6,0,2021
부산경남본부,양산지사,진영영업소,2128,594,584,10,2021
부산경남본부,울산지사,금정영업소,126,41,35,6,2021
부산경남본부,울산지사,기장일광영업소,289,163,112,51,2021
부산경남본부,울산지사,기장철마영업소,148,56,50,6,2021
부산경남본부,울산지사,동부산영업소,46,30,19,11,2021
부산경남본부,울산지사,문수영업소,291,148,108,40,2021
부산경남본부,울산지사,온양영업소,393,224,153,71,2021
부산경남본부,울산지사,울산영업소,727,282,245,37,2021
부산경남본부,울산지사,울산지사 교통안전팀,819,69,69,0,2021
부산경남본부,울산지사,장안영업소,323,118,96,22,2021
부산경남본부,울산지사,청량영업소,1879,733,643,90,2021
부산경남본부,울산지사,해운대송정영업소,437,267,176,91,2021
부산경남본부,진주지사,곤양영업소,284,96,85,11,2021
부산경남본부,진주지사,군북영업소,415,128,119,9,2021
부산경남본부,진주지사,문산영업소,707,202,200,2,2021
부산경남본부,진주지사,사천영업소,1416,386,378,8,2021
부산경남본부,진주지사,장지영업소,481,128,125,3,2021
부산경남본부,진주지사,지수영업소,276,90,73,17,2021
부산경남본부,진주지사,진교영업소,251,67,66,1,2021
부산경남본부,진주지사,진성영업소,496,145,133,12,2021
부산경남본부,진주지사,진주영업소,1719,482,481,1,2021
부산경남본부,진주지사,축동영업소,182,48,47,1,2021
부산경남본부,진주지사,하동영업소,1308,387,370,17,2021
부산경남본부,진주지사,함안영업소,683,202,194,8,2021
부산경남본부,창녕지사,남지영업소,555,163,160,3,2021
부산경남본부,창녕지사,내서영업소,360,97,97,0,2021
부산경남본부,창녕지사,달성영업소,504,144,139,5,2021
부산경남본부,창녕지사,영산영업소,667,178,178,0,2021
부산경남본부,창녕지사,창녕영업소,386,105,103,2,2021
부산경남본부,창녕지사,창녕지사 교통안전팀,6,2,2,0,2021
부산경남본부,창녕지사,칠서영업소,1209,352,339,13,2021
부산경남본부,창녕지사,칠원영업소,940,296,276,20,2021
부산경남본부,창녕지사,현풍영업소,939,238,238,0,2021
부산경남본부,창원지사,가락영업소,1085,326,322,4,2021
부산경남본부,창원지사,동창원영업소,1657,428,423,5,2021
부산경남본부,창원지사,마산영업소,1463,385,377,8,2021
부산경남본부,창원지사,북창원영업소,918,274,267,7,2021
부산경남본부,창원지사,산인영업소,3823,1032,990,42,2021
부산경남본부,창원지사,서부산영업소,1415,505,457,48,2021
부산경남본부,창원지사,장유영업소,687,189,189,0,2021
부산경남본부,창원지사,진례영업소,1027,284,281,3,2021
부산경남본부,창원지사,창원지사 고객지원팀,4,1,1,0,2021
부산경남본부,창원지사,창원지사 교통안전팀,4587,1525,1525,0,2021
수도권본부,경기광주지사,경기광주영업소,244,102,86,16,2021
수도권본부,경기광주지사,경기광주지사 교통안전팀,3259,816,816,0,2021
수도권본부,경기광주지사,경기광주지사 도로안전팀,4,1,1,0,2021
수도권본부,경기광주지사,곤지암영업소,303,109,103,6,2021
수도권본부,경기광주지사,동서울영업소,2786,1102,868,234,2021
수도권본부,경기광주지사,서이천영업소,659,230,207,23,2021
수도권본부,경기광주지사,하남영업소,1898,605,548,57,2021
수도권본부,군포지사,군자영업소,1064,420,363,57,2021
수도권본부,군포지사,군포영업소,92,36,32,4,2021
수도권본부,군포지사,군포지사 교통안전팀,7782,1946,1946,0,2021
수도권본부,군포지사,동군포영업소,153,51,51,0,2021
수도권본부,군포지사,동수원영업소,544,229,179,50,2021
수도권본부,군포지사,마성영업소,74,34,25,9,2021
수도권본부,군포지사,부곡영업소,456,142,133,9,2021
수도권본부,군포지사,북수원영업소,264,88,82,6,2021
수도권본부,군포지사,서안산영업소,493,153,153,0,2021
수도권본부,군포지사,안산영업소,128,44,42,2,2021
수도권본부,동서울지사,구리남양주영업소,3606,1324,1090,234,2021
수도권본부,동서울지사,동서울지사 교통안전팀,2827,708,707,1,2021
수도권본부,동서울지사,성남영업소,2088,861,707,154,2021
수도권본부,동서울지사,청계영업소,3705,1110,998,112,2021
수도권본부,동서울지사,토평영업소,327,125,112,13,2021
수도권본부,수도권본부 기술처,수도권본부 교통팀,179,53,53,0,2021
수도권본부,수원지사,기흥동탄영업소,259,78,73,5,2021
수도권본부,수원지사,기흥영업소,118,36,35,1,2021
수도권본부,수원지사,서울영업소,23095,6835,6830,5,2021
수도권본부,수원지사,수원신갈영업소,1061,319,295,24,2021
수도권본부,수원지사,수원지사 고객지원팀,5,0,0,0,2021
수도권본부,수원지사,수원지사 교통안전팀,3231,37,37,0,2021
수도권본부,수원지사,오산영업소,613,187,179,8,2021
수도권본부,수원지사,판교영업소,302,164,110,54,2021
수도권본부,시흥지사,남인천영업소,2116,941,764,177,2021
수도권본부,시흥지사,서서울영업소,3535,1984,1314,670,2021
수도권본부,시흥지사,시흥영업소,1727,709,609,100,2021
수도권본부,시흥지사,시흥지사 교통안전팀,188,61,61,0,2021
수도권본부,인천지사,김포영업소,3947,1664,1387,277,2021
수도권본부,인천지사,인천영업소,3889,2012,1449,563,2021
수도권본부,인천지사,인천지사 교통안전팀,1270,422,422,0,2021
수도권본부,화성지사,남안성영업소,336,102,98,4,2021
수도권본부,화성지사,매송영업소,177,44,44,0,2021
수도권본부,화성지사,발안영업소,511,151,148,3,2021
수도권본부,화성지사,비봉영업소,463,135,135,0,2021
수도권본부,화성지사,서안성영업소,805,241,236,5,2021
수도권본부,화성지사,서평택영업소,581,181,181,0,2021
수도권본부,화성지사,송탄영업소,428,124,122,2,2021
수도권본부,화성지사,청북영업소,567,155,154,1,2021
수도권본부,화성지사,평택고덕영업소,168,53,51,2,2021
수도권본부,화성지사,평택영업소,1301,398,375,23,2021
수도권본부,화성지사,화성지사 교통안전팀,3998,1000,1000,0,2021
전북본부,논산지사,계룡영업소,194,66,60,6,2021
전북본부,논산지사,논산영업소,424,133,126,7,2021
전북본부,논산지사,완주영업소,1412,376,373,3,2021
전북본부,논산지사,익산영업소,540,164,164,0,2021
전북본부,무주지사,금산영업소,63,22,19,3,2021
전북본부,무주지사,남대전영업소,451,138,132,6,2021
전북본부,무주지사,덕유산영업소,71,26,23,3,2021
전북본부,무주지사,무주영업소,104,32,32,0,2021
전북본부,무주지사,무주지사 교통안전팀,515,130,129,1,2021
전북본부,무주지사,추부영업소,119,36,33,3,2021
전북본부,보령지사,광천영업소,371,118,114,4,2021
전북본부,보령지사,군산영업소,364,112,112,0,2021
전북본부,보령지사,대천영업소,300,94,91,3,2021
전북본부,보령지사,무창포영업소,116,60,44,16,2021
전북본부,보령지사,보령지사 교통안전팀,560,140,140,0,2021
전북본부,보령지사,서천영업소,224,72,72,0,2021
전북본부,보령지사,춘장대영업소,41,15,14,1,2021
전북본부,부안지사,고창영업소,534,180,177,3,2021
전북본부,부안지사,동군산영업소,680,178,177,1,2021
전북본부,부안지사,부안영업소,516,159,158,1,2021
전북본부,부안지사,서김제영업소,128,40,40,0,2021
전북본부,부안지사,선운산영업소,361,111,101,10,2021
전북본부,부안지사,줄포영업소,73,23,23,0,2021
전북본부,전북본부 기술처,전북본부 교통팀,168,42,42,0,2021
전북본부,전주지사,금산사영업소,28,12,9,3,2021
전북본부,전주지사,김제영업소,82,26,26,0,2021
전북본부,전주지사,내장산영업소,27,9,9,0,2021
전북본부,전주지사,삼례영업소,118,38,36,2,2021
전북본부,전주지사,서전주영업소,163,49,49,0,2021
전북본부,전주지사,전주영업소,990,261,257,4,2021
전북본부,전주지사,전주지사 교통안전팀,1434,478,478,0,2021
전북본부,전주지사,정읍영업소,23,5,5,0,2021
전북본부,전주지사,태인영업소,72,24,23,1,2021
전북본부,진안지사,동전주영업소,30,10,9,1,2021
전북본부,진안지사,상관영업소,130,43,43,0,2021
전북본부,진안지사,소양영업소,93,31,31,0,2021
전북본부,진안지사,장수영업소,83,26,24,2,2021
전북본부,진안지사,진안영업소,48,15,15,0,2021
전북본부,진안지사,진안지사 교통안전팀,88,22,22,0,2021
지역본부,강원본부,강릉지사,291,97,97,0,2021
지역본부,광주전남본부,남원지사,165,55,55,0,2021
지역본부,대구경북본부,영천지사,1064,266,266,0,2021
지역본부,대전충남본부,공주지사,6,2,2,0,2021
지역본부,수도권본부,동서울지사,3,1,1,0,2021
지역본부,수도권본부,수원지사,6,2,2,0,2021
지역본부,수도권본부,화성지사,4,1,1,0,2021
지역본부,전북본부,논산지사,3,1,1,0,2021
지역본부,전북본부,전주지사,90,30,30,0,2021
지역본부,충북본부,제천지사,9,3,3,0,2021
충북본부,보은지사,남상주영업소,149,45,44,1,2021
충북본부,보은지사,문의영업소,299,80,78,2,2021
충북본부,보은지사,보은영업소,208,59,57,2,2021
충북본부,보은지사,속리산영업소,143,39,37,2,2021
충북본부,보은지사,화서영업소,216,65,60,5,2021
충북본부,보은지사,회인영업소,118,30,30,0,2021
충북본부,상주지사,문경새재영업소,150,41,40,1,2021
충북본부,상주지사,북상주영업소,138,38,37,1,2021
충북본부,상주지사,상주영업소,187,55,54,1,2021
충북본부,상주지사,상주지사 교통안전팀,428,107,107,0,2021
충북본부,상주지사,상주지사 교통안전팀,428,107,107,0,2021
충북본부,상주지사,점촌함창영업소,175,46,45,1,2021
충북본부,엄정지사,금왕꽃동네영업소,307,88,85,3,2021
충북본부,엄정지사,동충주영업소,361,108,107,1,2021
충북본부,엄정지사,북진천영업소,468,138,137,1,2021
충북본부,엄정지사,서충주영업소,260,95,82,13,2021
충북본부,엄정지사,엄정지사 교통안전팀,576,164,164,0,2021
충북본부,엄정지사,음성영업소,268,73,73,0,2021
충북본부,제천지사,남원주영업소,95,33,24,9,2021
충북본부,제천지사,남제천영업소,503,191,167,24,2021
충북본부,제천지사,단양영업소,161,103,66,37,2021
충북본부,제천지사,북단양영업소,217,79,70,9,2021
충북본부,제천지사,신림영업소,94,34,32,2,2021
충북본부,제천지사,제천영업소,184,80,66,14,2021
충북본부,제천지사,제천지사 교통안전팀,2074,594,593,1,2021
충북본부,제천지사,제천지사 교통안전팀,2074,594,593,1,2021
충북본부,진천지사,남이천영업소,587,193,185,8,2021
충북본부,진천지사,대소영업소,242,67,67,0,2021
충북본부,진천지사,서청주영업소,375,123,122,1,2021
충북본부,진천지사,오창영업소,222,65,65,0,2021
충북본부,진천지사,일죽영업소,4891,1443,1406,37,2021
충북본부,진천지사,증평영업소,452,139,134,5,2021
충북본부,진천지사,진천영업소,497,133,133,0,2021
충북본부,진천지사,진천지사 교통안전팀,201,67,67,0,2021
충북본부,진천지사,진천지사 교통안전팀,201,67,67,0,2021
충북본부,충주지사,감곡영업소,376,113,108,5,2021
충북본부,충주지사,괴산영업소,111,29,28,1,2021
충북본부,충주지사,북충주영업소,87,41,29,12,2021
충북본부,충주지사,연풍영업소,112,44,36,8,2021
충북본부,충주지사,충주영업소,117,27,27,0,2021
충북본부,충주지사,충주지사 교통안전팀,772,193,193,0,2021
한국도로공사,본사,건설본부,4,1,1,0,2021
한국도로공사,본사,건설본부,4,1,1,0,2021
한국도로공사,지역본부,대구경북본부,3,1,1,0,2021
한국도로공사,지역본부,수도권본부,6,2,2,0,2021
한국도로공사,지역본부,충북본부,3,1,1,0,2021
한국도로공사,지역본부,충북본부,3,1,1,0,2021
지역본부,광주전남본부,순천지사,6582,2049,2049,0,2021
지역본부,광주전남본부,함평지사,1587,477,474,3,2021
지역본부,대구경북본부,고령지사,2276,652,652,0,2021
지역본부,대구경북본부,구미지사,54,721,721,0,2021
지역본부,대구경북본부,군위지사,5,23,23,0,2021
지역본부,대구경북본부,대구지사,13,400,400,0,2021
지역본부,대구경북본부,성주지사,276,1750,1746,4,2021
지역본부,대구경북본부,영주지사,1,1389,1389,0,2021
지역본부,대구경북본부,영천지사,2288,655,649,6,2021
지역본부,대구경북본부,청송지사,7,5,3,2,2021
지역본부,대전충남본부,공주지사,1061,349,349,0,2021
지역본부,대전충남본부,당진지사,7712,1816,1816,0,2021
지역본부,대전충남본부,대전지사,131,865,865,0,2021
지역본부,대전충남본부,대전충남본부 기술처,463,157,156,1,2021
지역본부,대전충남본부,부여지사,1961,638,636,2,2021
지역본부,대전충남본부,영동지사,189,63,63,0,2021
지역본부,대전충남본부,천안지사,1454,486,485,1,2021
지역본부,부산경남본부,경주지사,215,90,86,4,2021
지역본부,부산경남본부,고성지사,357,864,864,0,2021
지역본부,부산경남본부,산청지사,10262,3437,3260,177,2021
지역본부,부산경남본부,양산지사,6157,2143,2075,68,2021
지역본부,부산경남본부,울산지사,174,795,795,0,2021
지역본부,부산경남본부,진주지사,11938,4284,3960,324,2021
지역본부,부산경남본부,창녕지사,11,1659,1659,0,2021
지역본부,부산경남본부,창원지사,3627,4505,4504,1,2021
지역본부,수도권본부,경기광주지사,13642,4253,4250,3,2021
지역본부,수도권본부,군포지사,20355,5555,5553,2,2021
지역본부,수도권본부,동서울지사,8061,1901,1824,77,2021
지역본부,수도권본부,수도권본부 관리처,193,63,62,1,2021
지역본부,수도권본부,수도권본부 기술처,3,1,1,0,2021
지역본부,수도권본부,수원지사,3387,390,390,0,2021
지역본부,수도권본부,시흥지사,28141,8599,8599,0,2021
지역본부,수도권본부,인천지사,47033,15349,15153,196,2021
지역본부,수도권본부,화성지사,3946,1315,1315,0,2021
지역본부,전북본부,논산지사,327,109,108,1,2021
지역본부,전북본부,무주지사,1385,455,453,2,2021
지역본부,전북본부,보령지사,14,462,462,0,2021
지역본부,전북본부,부안지사,7151,2347,2347,0,2021
지역본부,전북본부,전북본부 기술처,35,9,9,0,2021
지역본부,전북본부,전주지사,5194,1692,1692,0,2021
지역본부,전북본부,진안지사,550,183,183,0,2021
지역본부,충북본부,보은지사,685,175,175,0,2021
지역본부,충북본부,상주지사,3098,1016,1001,15,2021
지역본부,충북본부,엄정지사,955,307,307,0,2021
지역본부,충북본부,제천지사,1930,636,591,45,2021
지역본부,충북본부,진천지사,499,165,165,0,2021
지역본부,충북본부,충주지사,4673,1511,1511,0,2021
충북본부,보은지사,남상주영업소,4441,1491,1416,75,2021
충북본부,보은지사,문의영업소,5357,1687,1647,40,2021
충북본부,보은지사,보은영업소,2499,860,774,86,2021
충북본부,보은지사,보은지사 도로안전팀,234,78,78,0,2021
충북본부,보은지사,속리산영업소,3609,1125,1113,12,2021
충북본부,보은지사,화서영업소,2625,876,835,41,2021
충북본부,보은지사,회인영업소,1782,591,576,15,2021
충북본부,상주지사,문경새재영업소,2408,723,711,12,2021
충북본부,상주지사,북상주영업소,5653,1780,1740,40,2021
충북본부,상주지사,상주영업소,4475,1487,1412,75,2021
충북본부,상주지사,점촌함창영업소,4537,1398,1354,44,2021
충북본부,엄정지사,금왕꽃동네영업소,2466,712,703,9,2021
충북본부,엄정지사,동충주영업소,2116,704,641,63,2021
충북본부,엄정지사,북진천영업소,2849,915,863,52,2021
충북본부,엄정지사,서충주영업소,1119,449,373,76,2021
충북본부,엄정지사,엄정지사 교통안전팀,645,187,187,0,2021
충북본부,엄정지사,엄정지사 도로안전팀,476,145,145,0,2021
충북본부,엄정지사,음성영업소,1286,427,392,35,2021
충북본부,제천지사,남원주영업소,3916,1261,1190,71,2021
충북본부,제천지사,남제천영업소,4877,1803,1591,212,2021
충북본부,제천지사,단양영업소,3528,1763,1302,461,2021
충북본부,제천지사,북단양영업소,8911,4226,3241,985,2021
충북본부,제천지사,신림영업소,3444,1429,1187,242,2021
충북본부,제천지사,제천영업소,8584,2811,2689,122,2021
충북본부,제천지사,제천지사 고객지원팀,3,1,1,0,2021
충북본부,제천지사,제천지사 도로안전팀,172,53,51,2,2021
충북본부,진천지사,남이천영업소,2630,940,855,85,2021
충북본부,진천지사,대소영업소,5709,1697,1693,4,2021
충북본부,진천지사,서청주영업소,21894,6924,6877,47,2021
충북본부,진천지사,오창영업소,7678,2389,2351,38,2021
충북본부,진천지사,일죽영업소,38574,11636,11566,70,2021
충북본부,진천지사,증평영업소,9549,3094,2962,132,2021
충북본부,진천지사,진천영업소,2018,605,583,22,2021
충북본부,진천지사,진천지사 도로안전팀,87,29,29,0,2021
충북본부,충주지사,감곡영업소,6924,2211,2114,97,2021
충북본부,충주지사,괴산영업소,1121,365,339,26,2021
충북본부,충주지사,북충주영업소,3538,1224,1086,138,2021
충북본부,충주지사,연풍영업소,2275,702,675,27,2021
충북본부,충주지사,충주영업소,3467,1059,1031,28,2021
충북본부,충주지사,충주지사 고객지원팀,45,15,15,0,2021
충북본부,충주지사,충주지사 교통안전팀,775,194,194,0,2021
충북본부,충주지사,충주지사 도로안전팀,1212,370,370,0,2021
한국도로공사,지역본부,광주전남본부,2,2,1,1,2021
한국도로공사,지역본부,대구경북본부,13,4,4,0,2021
한국도로공사,지역본부,대전충남본부,7,4,4,0,2021
한국도로공사,지역본부,부산경남본부,0,1,1,0,2021
한국도로공사,지역본부,수도권본부,27,9,9,0,2021
한국도로공사,지역본부,전북본부,16,5,5,0,2021
강원본부,강릉지사,강릉영업소,310,91,90,1,2020
강원본부,강릉지사,근덕영업소,438,177,138,39,2020
강원본부,강릉지사,남강릉영업소,126,33,32,1,2020
강원본부,강릉지사,남양양영업소,49,31,19,12,2020
강원본부,강릉지사,동해영업소,464,209,155,54,2020
강원본부,강릉지사,망상영업소,40,14,13,1,2020
강원본부,강릉지사,북강릉영업소,44,16,14,2,2020
강원본부,강릉지사,삼척영업소,102,58,39,19,2020
강원본부,강릉지사,옥계영업소,160,44,43,1,2020
강원본부,대관령지사,대관령영업소,183,47,47,0,2020
강원본부,대관령지사,대관령지사 교통안전팀,642,178,177,1,2020
강원본부,대관령지사,면온영업소,173,43,43,0,2020
강원본부,대관령지사,속사영업소,96,37,28,9,2020
강원본부,대관령지사,진부영업소,97,33,29,4,2020
강원본부,대관령지사,평창영업소,278,106,86,20,2020
강원본부,양양지사,내촌영업소,38,14,13,1,2020
강원본부,양양지사,북양양영업소,108,31,31,0,2020
강원본부,양양지사,서양양영업소,35,13,12,1,2020
강원본부,양양지사,속초영업소,173,59,58,1,2020
강원본부,양양지사,양양영업소,224,94,76,18,2020
강원본부,양양지사,인제영업소,214,74,72,2,2020
강원본부,양양지사,하조대영업소,79,25,25,0,2020
강원본부,원주지사,둔내영업소,31,7,7,0,2020
강원본부,원주지사,문막영업소,481,171,158,13,2020
강원본부,원주지사,새말영업소,90,30,29,1,2020
강원본부,원주지사,여주영업소,158,53,47,6,2020
강원본부,원주지사,원주영업소,273,91,86,5,2020
강원본부,원주지사,원주지사 교통안전팀,675,169,169,0,2020
강원본부,이천지사,남여주영업소,145,47,44,3,2020
강원본부,이천지사,덕평영업소,439,165,149,16,2020
강원본부,이천지사,북여주영업소,118,68,45,23,2020
강원본부,이천지사,서여주영업소,36,16,13,3,2020
강원본부,이천지사,양지영업소,546,215,187,28,2020
강원본부,이천지사,양평영업소,116,48,41,7,2020
강원본부,이천지사,용인영업소,289,108,89,19,2020
강원본부,이천지사,이천영업소,264,87,86,1,2020
강원본부,이천지사,이천지사 교통안전팀,2887,722,722,0,2020
강원본부,춘천지사,강촌영업소,19,5,5,0,2020
강원본부,춘천지사,남양주영업소,66,22,21,1,2020
강원본부,춘천지사,남춘천영업소,3,1,1,0,2020
강원본부,춘천지사,덕소삼패영업소,209,179,97,82,2020
강원본부,춘천지사,동홍천영업소,53,11,11,0,2020
강원본부,춘천지사,서종영업소,9,3,3,0,2020
강원본부,춘천지사,설악영업소,21,7,7,0,2020
강원본부,춘천지사,조양영업소,8,1,1,0,2020
강원본부,춘천지사,춘천지사 고객지원팀,3,1,1,0,2020
강원본부,춘천지사,화도영업소,120,41,39,2,2020
강원본부,홍천지사,북원주영업소,66,22,21,1,2020
강원본부,홍천지사,춘천영업소,212,77,68,9,2020
강원본부,홍천지사,홍천영업소,294,75,72,3,2020
강원본부,홍천지사,횡성영업소,248,131,88,43,2020
광주전남본부,광주전남본부 기술처,광주전남본부 교통팀,339,91,90,1,2020
광주전남본부,광주지사,광주영업소,334,111,105,6,2020
광주전남본부,광주지사,광주지사 교통안전팀,1191,298,298,0,2020
광주전남본부,광주지사,담양영업소,65,19,19,0,2020
광주전남본부,광주지사,동광주영업소,291,84,82,2,2020
광주전남본부,광주지사,백양사영업소,47,13,13,0,2020
광주전남본부,광주지사,장성영업소,172,44,44,0,2020
광주전남본부,광주지사,창평영업소,61,20,20,0,2020
광주전남본부,구례지사,구례화엄사영업소,227,91,68,23,2020
광주전남본부,구례지사,동순천영업소,471,138,134,4,2020
광주전남본부,구례지사,북남원영업소,158,63,47,16,2020
광주전남본부,구례지사,서남원영업소,148,49,42,7,2020
광주전남본부,구례지사,오수영업소,184,59,48,11,2020
광주전남본부,구례지사,임실영업소,139,37,37,0,2020
광주전남본부,구례지사,황전영업소,154,43,42,1,2020
광주전남본부,남원지사,남원영업소,141,41,39,2,2020
광주전남본부,남원지사,남원지사 교통안전팀,52,13,13,0,2020
광주전남본부,남원지사,동남원영업소,184,46,46,0,2020
광주전남본부,남원지사,순창영업소,477,128,125,3,2020
광주전남본부,남원지사,지리산영업소,431,110,110,0,2020
광주전남본부,담양지사,곡성영업소,91,29,27,2,2020
광주전남본부,담양지사,남고창영업소,127,65,45,20,2020
광주전남본부,담양지사,담양지사 교통안전팀,604,151,151,0,2020
광주전남본부,담양지사,북광주영업소,227,60,60,0,2020
광주전남본부,담양지사,옥과영업소,329,101,90,11,2020
광주전남본부,담양지사,장성물류영업소,46,14,14,0,2020
광주전남본부,보성지사,강진무위사영업소,380,119,119,0,2020
광주전남본부,보성지사,보성지사 고흥영업소,365,118,118,0,2020
광주전남본부,보성지사,보성지사 남순천영업소,926,260,258,2,2020
광주전남본부,보성지사,보성지사 벌교영업소,291,86,86,0,2020
광주전남본부,보성지사,보성지사 보성영업소,137,44,44,0,2020
광주전남본부,보성지사,서영암영업소,273,85,84,1,2020
광주전남본부,보성지사,순천만영업소,381,123,122,1,2020
광주전남본부,보성지사,장흥영업소,198,66,66,0,2020
광주전남본부,순천지사,광양영업소,454,140,137,3,2020
광주전남본부,순천지사,동광양영업소,229,75,72,3,2020
광주전남본부,순천지사,서순천영업소,134,46,44,2,2020
광주전남본부,순천지사,석곡영업소,27,8,8,0,2020
광주전남본부,순천지사,송광사영업소,55,14,14,0,2020
광주전남본부,순천지사,순천영업소,298,104,92,12,2020
광주전남본부,순천지사,순천지사 교통안전팀,1147,287,287,0,2020
광주전남본부,순천지사,승주영업소,86,24,22,2,2020
광주전남본부,순천지사,옥곡영업소,221,95,79,16,2020
광주전남본부,순천지사,진월영업소,589,208,192,16,2020
광주전남본부,함평지사,나주영업소,326,90,86,4,2020
광주전남본부,함평지사,동광산영업소,374,113,104,9,2020
광주전남본부,함평지사,동함평영업소,355,125,103,22,2020
광주전남본부,함평지사,목포영업소,659,196,186,10,2020
광주전남본부,함평지사,무안공항영업소,257,68,68,0,2020
광주전남본부,함평지사,무안영업소,598,161,161,0,2020
광주전남본부,함평지사,문평영업소,3,1,1,0,2020
광주전남본부,함평지사,서광산영업소,159,69,56,13,2020
광주전남본부,함평지사,영광영업소,148,48,46,2,2020
광주전남본부,함평지사,함평영업소,29,7,7,0,2020
광주전남본부,함평지사,함평지사 교통안전팀,32,8,8,0,2020
대구경북본부,고령지사,가조영업소,127,40,40,0,2020
대구경북본부,고령지사,거창영업소,230,101,77,24,2020
대구경북본부,고령지사,고령영업소,257,91,77,14,2020
대구경북본부,고령지사,고령지사 교통안전팀,456,114,114,0,2020
대구경북본부,고령지사,동고령영업소,408,163,136,27,2020
대구경북본부,고령지사,함양영업소,145,51,47,4,2020
대구경북본부,고령지사,해인사영업소,76,27,24,3,2020
대구경북본부,구미지사,구미영업소,1069,342,327,15,2020
대구경북본부,구미지사,구미지사 교통안전팀,456,127,127,0,2020
대구경북본부,구미지사,김천영업소,317,85,85,0,2020
대구경북본부,구미지사,남구미영업소,625,194,185,9,2020
대구경북본부,구미지사,동김천영업소,251,96,74,22,2020
대구경북본부,구미지사,왜관영업소,1011,299,283,16,2020
대구경북본부,구미지사,추풍령영업소,134,38,38,0,2020
대구경북본부,구미지사,칠곡물류영업소,587,194,184,10,2020
대구경북본부,군위지사,가산영업소,752,254,224,30,2020
대구경북본부,군위지사,군위영업소,235,91,76,15,2020
대구경북본부,군위지사,군위지사 교통안전팀,1586,397,397,0,2020
대구경북본부,군위지사,남대구영업소,1422,611,465,146,2020
대구경북본부,군위지사,다부영업소,231,65,62,3,2020
대구경북본부,군위지사,서대구영업소,2551,824,787,37,2020
대구경북본부,군위지사,의성영업소,430,128,128,0,2020
대구경북본부,군위지사,칠곡영업소,543,237,182,55,2020
대구경북본부,군위지사,화원옥포영업소,1520,454,449,5,2020
대구경북본부,대구경북본부 기술처,대구경북본부 교통팀,15,5,5,0,2020
대구경북본부,대구지사,건천영업소,782,264,231,33,2020
대구경북본부,대구지사,경산영업소,1525,434,433,1,2020
대구경북본부,대구지사,경주영업소,1703,531,505,26,2020
대구경북본부,대구지사,대구지사 교통안전팀,177,59,59,0,2020
대구경북본부,대구지사,북대구영업소,2046,701,614,87,2020
대구경북본부,대구지사,영천영업소,940,262,260,2,2020
대구경북본부,성주지사,남김천영업소,411,230,145,85,2020
대구경북본부,성주지사,남성주영업소,247,70,69,1,2020
대구경북본부,성주지사,선산영업소,87,27,25,2,2020
대구경북본부,성주지사,성주영업소,171,66,58,8,2020
대구경북본부,성주지사,성주지사 교통안전팀,336,84,84,0,2020
대구경북본부,영주지사,남안동영업소,162,54,49,5,2020
대구경북본부,영주지사,서안동영업소,122,46,38,8,2020
대구경북본부,영주지사,영주영업소,345,122,106,16,2020
대구경북본부,영주지사,영주지사 교통안전팀,1651,481,481,0,2020
대구경북본부,영주지사,예천영업소,22,6,5,1,2020
대구경북본부,영주지사,풍기영업소,330,86,85,1,2020
대구경북본부,영천지사,북영천영업소,191,56,55,1,2020
대구경북본부,영천지사,서포항영업소,264,85,84,1,2020
대구경북본부,영천지사,청통와촌영업소,197,57,55,2,2020
대구경북본부,영천지사,팔공산영업소,481,152,137,15,2020
대구경북본부,영천지사,포항영업소,1152,405,372,33,2020
대구경북본부,청송지사,청송지사 동상주영업소,133,53,44,9,2020
대구경북본부,청송지사,청송지사 동안동영업소,141,59,46,13,2020
대구경북본부,청송지사,청송지사 동청송영양영업소,62,39,25,14,2020
대구경북본부,청송지사,청송지사 북의성영업소,71,26,24,2,2020
대구경북본부,청송지사,청송지사 서의성영업소,146,50,47,3,2020
대구경북본부,청송지사,청송지사 영덕영업소,141,68,51,17,2020
대구경북본부,청송지사,청송지사 청송영업소,82,28,26,2,2020
대전충남본부,공주지사,공주영업소,363,107,106,1,2020
대전충남본부,공주지사,남세종영업소,357,105,105,0,2020
대전충남본부,공주지사,마곡사영업소,133,38,37,1,2020
대전충남본부,공주지사,서세종영업소,506,151,149,2,2020
대전충남본부,공주지사,신양영업소,459,143,143,0,2020
대전충남본부,공주지사,예산영업소,610,171,168,3,2020
대전충남본부,공주지사,유구영업소,211,59,58,1,2020
대전충남본부,당진지사,고덕영업소,844,238,238,0,2020
대전충남본부,당진지사,당진영업소,1237,359,359,0,2020
대전충남본부,당진지사,면천영업소,995,287,278,9,2020
대전충남본부,당진지사,서산영업소,1213,355,353,2,2020
대전충남본부,당진지사,송악영업소,2201,639,632,7,2020
대전충남본부,당진지사,해미영업소,832,242,242,0,2020
대전충남본부,당진지사,홍성영업소,616,182,181,1,2020
대전충남본부,대전지사,남청주영업소,2286,582,578,4,2020
대전충남본부,대전지사,대전영업소,942,265,256,9,2020
대전충남본부,대전지사,대전지사 고객지원팀,4,0,0,0,2020
대전충남본부,대전지사,대전지사 교통안전팀,780,195,195,0,2020
대전충남본부,대전지사,북대전영업소,784,215,208,7,2020
대전충남본부,대전지사,신탄진영업소,1095,285,284,1,2020
대전충남본부,대전지사,유성영업소,942,261,257,4,2020
대전충남본부,대전충남본부 기술처,대전충남본부 교통팀,405,135,135,0,2020
대전충남본부,부여지사,동서천영업소,362,115,113,2,2020
대전충남본부,부여지사,부여영업소,192,50,50,0,2020
대전충남본부,부여지사,부여지사 교통안전팀,21,7,7,0,2020
대전충남본부,부여지사,서공주영업소,336,89,88,1,2020
대전충남본부,부여지사,서부여영업소,318,104,104,0,2020
대전충남본부,부여지사,청양영업소,107,30,30,0,2020
대전충남본부,영동지사,금강영업소,108,32,30,2,2020
대전충남본부,영동지사,서대전영업소,252,87,82,5,2020
대전충남본부,영동지사,안영영업소,212,75,63,12,2020
대전충남본부,영동지사,영동영업소,142,42,41,1,2020
대전충남본부,영동지사,옥천영업소,544,156,155,1,2020
대전충남본부,영동지사,판암영업소,218,77,65,12,2020
대전충남본부,영동지사,황간영업소,131,40,38,2,2020
대전충남본부,천안지사,목천영업소,551,165,157,8,2020
대전충남본부,천안지사,북천안영업소,776,259,245,14,2020
대전충남본부,천안지사,안성영업소,193,62,58,4,2020
대전충남본부,천안지사,천안영업소,595,180,180,0,2020
대전충남본부,천안지사,청주영업소,523,151,150,1,2020
부산경남본부,경주지사,남경주영업소,582,170,166,4,2020
부산경남본부,경주지사,남포항영업소,1518,497,448,49,2020
부산경남본부,경주지사,동경주영업소,183,69,61,8,2020
부산경남본부,경주지사,범서영업소,205,66,62,4,2020
부산경남본부,고성지사,고성영업소,464,140,133,7,2020
부산경남본부,고성지사,고성지사 교통안전팀,78,26,26,0,2020
부산경남본부,고성지사,동고성영업소,309,85,85,0,2020
부산경남본부,고성지사,북통영영업소,259,70,70,0,2020
부산경남본부,고성지사,연화산영업소,293,81,79,2,2020
부산경남본부,고성지사,통영영업소,632,184,184,0,2020
부산경남본부,부산경남본부 기술처,부산경남본부 교통팀,93,31,31,0,2020
부산경남본부,산청지사,단성영업소,759,207,201,6,2020
부산경남본부,산청지사,산청영업소,600,157,154,3,2020
부산경남본부,산청지사,산청지사 교통안전팀,1930,643,643,0,2020
부산경남본부,산청지사,생초영업소,480,219,152,67,2020
부산경남본부,산청지사,서상영업소,194,75,56,19,2020
부산경남본부,산청지사,서진주영업소,359,117,97,20,2020
부산경남본부,산청지사,지곡영업소,696,187,185,2,2020
부산경남본부,서울산지사,노포영업소,334,80,78,2,2020
부산경남본부,서울산지사,부산영업소,1798,591,517,74,2020
부산경남본부,서울산지사,서울산영업소,915,261,249,12,2020
부산경남본부,서울산지사,서울산지사 교통안전팀,6,2,2,0,2020
부산경남본부,서울산지사,양산영업소,849,250,239,11,2020
부산경남본부,서울산지사,통도사영업소,1009,271,266,5,2020
부산경남본부,서울산지사,활천영업소,554,150,148,2,2020
부산경남본부,양산지사,광재영업소,1254,428,412,16,2020
부산경남본부,양산지사,남양산영업소,1491,426,407,19,2020
부산경남본부,양산지사,대동영업소,5605,1827,1680,147,2020
부산경남본부,양산지사,동김해영업소,525,145,144,1,2020
부산경남본부,양산지사,물금영업소,594,178,175,3,2020
부산경남본부,양산지사,북부산영업소,1086,383,339,44,2020
부산경남본부,양산지사,서김해영업소,806,220,216,4,2020
부산경남본부,양산지사,양산지사 교통안전팀,888,296,296,0,2020
부산경남본부,양산지사,양산지사 한림영업소,26,6,6,0,2020
부산경남본부,양산지사,진영영업소,2128,594,584,10,2020
부산경남본부,울산지사,금정영업소,126,41,35,6,2020
부산경남본부,울산지사,기장일광영업소,289,163,112,51,2020
부산경남본부,울산지사,기장철마영업소,148,56,50,6,2020
부산경남본부,울산지사,동부산영업소,46,30,19,11,2020
부산경남본부,울산지사,문수영업소,291,148,108,40,2020
부산경남본부,울산지사,온양영업소,393,224,153,71,2020
부산경남본부,울산지사,울산영업소,727,282,245,37,2020
부산경남본부,울산지사,울산지사 교통안전팀,819,69,69,0,2020
부산경남본부,울산지사,장안영업소,323,118,96,22,2020
부산경남본부,울산지사,청량영업소,1879,733,643,90,2020
부산경남본부,울산지사,해운대송정영업소,437,267,176,91,2020
부산경남본부,진주지사,곤양영업소,284,96,85,11,2020
부산경남본부,진주지사,군북영업소,415,128,119,9,2020
부산경남본부,진주지사,문산영업소,707,202,200,2,2020
부산경남본부,진주지사,사천영업소,1416,386,378,8,2020
부산경남본부,진주지사,장지영업소,481,128,125,3,2020
부산경남본부,진주지사,지수영업소,276,90,73,17,2020
부산경남본부,진주지사,진교영업소,251,67,66,1,2020
부산경남본부,진주지사,진성영업소,496,145,133,12,2020
부산경남본부,진주지사,진주영업소,1719,482,481,1,2020
부산경남본부,진주지사,축동영업소,182,48,47,1,2020
부산경남본부,진주지사,하동영업소,1308,387,370,17,2020
부산경남본부,진주지사,함안영업소,683,202,194,8,2020
부산경남본부,창녕지사,남지영업소,555,163,160,3,2020
부산경남본부,창녕지사,내서영업소,360,97,97,0,2020
부산경남본부,창녕지사,달성영업소,504,144,139,5,2020
부산경남본부,창녕지사,영산영업소,667,178,178,0,2020
부산경남본부,창녕지사,창녕영업소,386,105,103,2,2020
부산경남본부,창녕지사,창녕지사 교통안전팀,6,2,2,0,2020
부산경남본부,창녕지사,칠서영업소,1209,352,339,13,2020
부산경남본부,창녕지사,칠원영업소,940,296,276,20,2020
부산경남본부,창녕지사,현풍영업소,939,238,238,0,2020
부산경남본부,창원지사,가락영업소,1085,326,322,4,2020
부산경남본부,창원지사,동창원영업소,1657,428,423,5,2020
부산경남본부,창원지사,마산영업소,1463,385,377,8,2020
부산경남본부,창원지사,북창원영업소,918,274,267,7,2020
부산경남본부,창원지사,산인영업소,3823,1032,990,42,2020
부산경남본부,창원지사,서부산영업소,1415,505,457,48,2020
부산경남본부,창원지사,장유영업소,687,189,189,0,2020
부산경남본부,창원지사,진례영업소,1027,284,281,3,2020
부산경남본부,창원지사,창원지사 고객지원팀,4,1,1,0,2020
부산경남본부,창원지사,창원지사 교통안전팀,4587,1525,1525,0,2020
수도권본부,경기광주지사,경기광주영업소,244,102,86,16,2020
수도권본부,경기광주지사,경기광주지사 교통안전팀,3259,816,816,0,2020
수도권본부,경기광주지사,경기광주지사 도로안전팀,4,1,1,0,2020
수도권본부,경기광주지사,곤지암영업소,303,109,103,6,2020
수도권본부,경기광주지사,동서울영업소,2786,1102,868,234,2020
수도권본부,경기광주지사,서이천영업소,659,230,207,23,2020
수도권본부,경기광주지사,하남영업소,1898,605,548,57,2020
수도권본부,군포지사,군자영업소,1064,420,363,57,2020
수도권본부,군포지사,군포영업소,92,36,32,4,2020
수도권본부,군포지사,군포지사 교통안전팀,7782,1946,1946,0,2020
수도권본부,군포지사,동군포영업소,153,51,51,0,2020
수도권본부,군포지사,동수원영업소,544,229,179,50,2020
수도권본부,군포지사,마성영업소,74,34,25,9,2020
수도권본부,군포지사,부곡영업소,456,142,133,9,2020
수도권본부,군포지사,북수원영업소,264,88,82,6,2020
수도권본부,군포지사,서안산영업소,493,153,153,0,2020
수도권본부,군포지사,안산영업소,128,44,42,2,2020
수도권본부,동서울지사,구리남양주영업소,3606,1324,1090,234,2020
수도권본부,동서울지사,동서울지사 교통안전팀,2827,708,707,1,2020
수도권본부,동서울지사,성남영업소,2088,861,707,154,2020
수도권본부,동서울지사,청계영업소,3705,1110,998,112,2020
수도권본부,동서울지사,토평영업소,327,125,112,13,2020
수도권본부,수도권본부 기술처,수도권본부 교통팀,179,53,53,0,2020
수도권본부,수원지사,기흥동탄영업소,259,78,73,5,2020
수도권본부,수원지사,기흥영업소,118,36,35,1,2020
수도권본부,수원지사,서울영업소,23095,6835,6830,5,2020
수도권본부,수원지사,수원신갈영업소,1061,319,295,24,2020
수도권본부,수원지사,수원지사 고객지원팀,5,0,0,0,2020
수도권본부,수원지사,수원지사 교통안전팀,3231,37,37,0,2020
수도권본부,수원지사,오산영업소,613,187,179,8,2020
수도권본부,수원지사,판교영업소,302,164,110,54,2020
수도권본부,시흥지사,남인천영업소,2116,941,764,177,2020
수도권본부,시흥지사,서서울영업소,3535,1984,1314,670,2020
수도권본부,시흥지사,시흥영업소,1727,709,609,100,2020
수도권본부,시흥지사,시흥지사 교통안전팀,188,61,61,0,2020
수도권본부,인천지사,김포영업소,3947,1664,1387,277,2020
수도권본부,인천지사,인천영업소,3889,2012,1449,563,2020
수도권본부,인천지사,인천지사 교통안전팀,1270,422,422,0,2020
수도권본부,화성지사,남안성영업소,336,102,98,4,2020
수도권본부,화성지사,매송영업소,177,44,44,0,2020
수도권본부,화성지사,발안영업소,511,151,148,3,2020
수도권본부,화성지사,비봉영업소,463,135,135,0,2020
수도권본부,화성지사,서안성영업소,805,241,236,5,2020
수도권본부,화성지사,서평택영업소,581,181,181,0,2020
수도권본부,화성지사,송탄영업소,428,124,122,2,2020
수도권본부,화성지사,청북영업소,567,155,154,1,2020
수도권본부,화성지사,평택고덕영업소,168,53,51,2,2020
수도권본부,화성지사,평택영업소,1301,398,375,23,2020
수도권본부,화성지사,화성지사 교통안전팀,3998,1000,1000,0,2020
전북본부,논산지사,계룡영업소,194,66,60,6,2020
전북본부,논산지사,논산영업소,424,133,126,7,2020
전북본부,논산지사,완주영업소,1412,376,373,3,2020
전북본부,논산지사,익산영업소,540,164,164,0,2020
전북본부,무주지사,금산영업소,63,22,19,3,2020
전북본부,무주지사,남대전영업소,451,138,132,6,2020
전북본부,무주지사,덕유산영업소,71,26,23,3,2020
전북본부,무주지사,무주영업소,104,32,32,0,2020
전북본부,무주지사,무주지사 교통안전팀,515,130,129,1,2020
전북본부,무주지사,추부영업소,119,36,33,3,2020
전북본부,보령지사,광천영업소,371,118,114,4,2020
전북본부,보령지사,군산영업소,364,112,112,0,2020
전북본부,보령지사,대천영업소,300,94,91,3,2020
전북본부,보령지사,무창포영업소,116,60,44,16,2020
전북본부,보령지사,보령지사 교통안전팀,560,140,140,0,2020
전북본부,보령지사,서천영업소,224,72,72,0,2020
전북본부,보령지사,춘장대영업소,41,15,14,1,2020
전북본부,부안지사,고창영업소,534,180,177,3,2020
전북본부,부안지사,동군산영업소,680,178,177,1,2020
전북본부,부안지사,부안영업소,516,159,158,1,2020
전북본부,부안지사,서김제영업소,128,40,40,0,2020
전북본부,부안지사,선운산영업소,361,111,101,10,2020
전북본부,부안지사,줄포영업소,73,23,23,0,2020
전북본부,전북본부 기술처,전북본부 교통팀,168,42,42,0,2020
전북본부,전주지사,금산사영업소,28,12,9,3,2020
전북본부,전주지사,김제영업소,82,26,26,0,2020
전북본부,전주지사,내장산영업소,27,9,9,0,2020
전북본부,전주지사,삼례영업소,118,38,36,2,2020
전북본부,전주지사,서전주영업소,163,49,49,0,2020
전북본부,전주지사,전주영업소,990,261,257,4,2020
전북본부,전주지사,전주지사 교통안전팀,1434,478,478,0,2020
전북본부,전주지사,정읍영업소,23,5,5,0,2020
전북본부,전주지사,태인영업소,72,24,23,1,2020
전북본부,진안지사,동전주영업소,30,10,9,1,2020
전북본부,진안지사,상관영업소,130,43,43,0,2020
전북본부,진안지사,소양영업소,93,31,31,0,2020
전북본부,진안지사,장수영업소,83,26,24,2,2020
전북본부,진안지사,진안영업소,48,15,15,0,2020
전북본부,진안지사,진안지사 교통안전팀,88,22,22,0,2020
지역본부,강원본부,강릉지사,291,97,97,0,2020
지역본부,광주전남본부,남원지사,165,55,55,0,2020
지역본부,대구경북본부,영천지사,1064,266,266,0,2020
지역본부,대전충남본부,공주지사,6,2,2,0,2020
지역본부,수도권본부,동서울지사,3,1,1,0,2020
지역본부,수도권본부,수원지사,6,2,2,0,2020
지역본부,수도권본부,화성지사,4,1,1,0,2020
지역본부,전북본부,논산지사,3,1,1,0,2020
지역본부,전북본부,전주지사,90,30,30,0,2020
지역본부,충북본부,제천지사,9,3,3,0,2020
충북본부,보은지사,남상주영업소,149,45,44,1,2020
충북본부,보은지사,문의영업소,299,80,78,2,2020
충북본부,보은지사,보은영업소,208,59,57,2,2020
충북본부,보은지사,속리산영업소,143,39,37,2,2020
충북본부,보은지사,화서영업소,216,65,60,5,2020
충북본부,보은지사,회인영업소,118,30,30,0,2020
충북본부,상주지사,문경새재영업소,150,41,40,1,2020
충북본부,상주지사,북상주영업소,138,38,37,1,2020
충북본부,상주지사,상주영업소,187,55,54,1,2020
충북본부,상주지사,상주지사 교통안전팀,428,107,107,0,2020
충북본부,상주지사,상주지사 교통안전팀,428,107,107,0,2020
충북본부,상주지사,점촌함창영업소,175,46,45,1,2020
충북본부,엄정지사,금왕꽃동네영업소,307,88,85,3,2020
충북본부,엄정지사,동충주영업소,361,108,107,1,2020
충북본부,엄정지사,북진천영업소,468,138,137,1,2020
충북본부,엄정지사,서충주영업소,260,95,82,13,2020
충북본부,엄정지사,엄정지사 교통안전팀,576,164,164,0,2020
충북본부,엄정지사,음성영업소,268,73,73,0,2020
충북본부,제천지사,남원주영업소,95,33,24,9,2020
충북본부,제천지사,남제천영업소,503,191,167,24,2020
충북본부,제천지사,단양영업소,161,103,66,37,2020
충북본부,제천지사,북단양영업소,217,79,70,9,2020
충북본부,제천지사,신림영업소,94,34,32,2,2020
충북본부,제천지사,제천영업소,184,80,66,14,2020
충북본부,제천지사,제천지사 교통안전팀,2074,594,593,1,2020
충북본부,제천지사,제천지사 교통안전팀,2074,594,593,1,2020
충북본부,진천지사,남이천영업소,587,193,185,8,2020
충북본부,진천지사,대소영업소,242,67,67,0,2020
충북본부,진천지사,서청주영업소,375,123,122,1,2020
충북본부,진천지사,오창영업소,222,65,65,0,2020
충북본부,진천지사,일죽영업소,4891,1443,1406,37,2020
충북본부,진천지사,증평영업소,452,139,134,5,2020
충북본부,진천지사,진천영업소,497,133,133,0,2020
충북본부,진천지사,진천지사 교통안전팀,201,67,67,0,2020
충북본부,진천지사,진천지사 교통안전팀,201,67,67,0,2020
충북본부,충주지사,감곡영업소,376,113,108,5,2020
충북본부,충주지사,괴산영업소,111,29,28,1,2020
충북본부,충주지사,북충주영업소,87,41,29,12,2020
충북본부,충주지사,연풍영업소,112,44,36,8,2020
충북본부,충주지사,충주영업소,117,27,27,0,2020
충북본부,충주지사,충주지사 교통안전팀,772,193,193,0,2020
한국도로공사,본사,건설본부,4,1,1,0,2020
한국도로공사,본사,건설본부,4,1,1,0,2020
한국도로공사,지역본부,대구경북본부,3,1,1,0,2020
한국도로공사,지역본부,수도권본부,6,2,2,0,2020
한국도로공사,지역본부,충북본부,3,1,1,0,2020
한국도로공사,지역본부,충북본부,3,1,1,0,2020
지역본부,광주전남본부,순천지사,6582,2049,2049,0,2020
지역본부,광주전남본부,함평지사,1587,477,474,3,2020
지역본부,대구경북본부,고령지사,2276,652,652,0,2020
지역본부,대구경북본부,구미지사,54,721,721,0,2020
지역본부,대구경북본부,군위지사,5,23,23,0,2020
지역본부,대구경북본부,대구지사,13,400,400,0,2020
지역본부,대구경북본부,성주지사,276,1750,1746,4,2020
지역본부,대구경북본부,영주지사,1,1389,1389,0,2020
지역본부,대구경북본부,영천지사,2288,655,649,6,2020
지역본부,대구경북본부,청송지사,7,5,3,2,2020
지역본부,대전충남본부,공주지사,1061,349,349,0,2020
지역본부,대전충남본부,당진지사,7712,1816,1816,0,2020
지역본부,대전충남본부,대전지사,131,865,865,0,2020
지역본부,대전충남본부,대전충남본부 기술처,463,157,156,1,2020
지역본부,대전충남본부,부여지사,1961,638,636,2,2020
지역본부,대전충남본부,영동지사,189,63,63,0,2020
지역본부,대전충남본부,천안지사,1454,486,485,1,2020
지역본부,부산경남본부,경주지사,215,90,86,4,2020
지역본부,부산경남본부,고성지사,357,864,864,0,2020
지역본부,부산경남본부,산청지사,10262,3437,3260,177,2020
지역본부,부산경남본부,양산지사,6157,2143,2075,68,2020
지역본부,부산경남본부,울산지사,174,795,795,0,2020
지역본부,부산경남본부,진주지사,11938,4284,3960,324,2020
지역본부,부산경남본부,창녕지사,11,1659,1659,0,2020
지역본부,부산경남본부,창원지사,3627,4505,4504,1,2020
지역본부,수도권본부,경기광주지사,13642,4253,4250,3,2020
지역본부,수도권본부,군포지사,20355,5555,5553,2,2020
지역본부,수도권본부,동서울지사,8061,1901,1824,77,2020
지역본부,수도권본부,수도권본부 관리처,193,63,62,1,2020
지역본부,수도권본부,수도권본부 기술처,3,1,1,0,2020
지역본부,수도권본부,수원지사,3387,390,390,0,2020
지역본부,수도권본부,시흥지사,28141,8599,8599,0,2020
지역본부,수도권본부,인천지사,47033,15349,15153,196,2020
지역본부,수도권본부,화성지사,3946,1315,1315,0,2020
지역본부,전북본부,논산지사,327,109,108,1,2020
지역본부,전북본부,무주지사,1385,455,453,2,2020
지역본부,전북본부,보령지사,14,462,462,0,2020
지역본부,전북본부,부안지사,7151,2347,2347,0,2020
지역본부,전북본부,전북본부 기술처,35,9,9,0,2020
지역본부,전북본부,전주지사,5194,1692,1692,0,2020
지역본부,전북본부,진안지사,550,183,183,0,2020
지역본부,충북본부,보은지사,685,175,175,0,2020
지역본부,충북본부,상주지사,3098,1016,1001,15,2020
지역본부,충북본부,엄정지사,955,307,307,0,2020
지역본부,충북본부,제천지사,1930,636,591,45,2020
지역본부,충북본부,진천지사,499,165,165,0,2020
지역본부,충북본부,충주지사,4673,1511,1511,0,2020
충북본부,보은지사,남상주영업소,4441,1491,1416,75,2020
충북본부,보은지사,문의영업소,5357,1687,1647,40,2020
충북본부,보은지사,보은영업소,2499,860,774,86,2020
충북본부,보은지사,보은지사 도로안전팀,234,78,78,0,2020
충북본부,보은지사,속리산영업소,3609,1125,1113,12,2020
충북본부,보은지사,화서영업소,2625,876,835,41,2020
충북본부,보은지사,회인영업소,1782,591,576,15,2020
충북본부,상주지사,문경새재영업소,2408,723,711,12,2020
충북본부,상주지사,북상주영업소,5653,1780,1740,40,2020
충북본부,상주지사,상주영업소,4475,1487,1412,75,2020
충북본부,상주지사,점촌함창영업소,4537,1398,1354,44,2020
충북본부,엄정지사,금왕꽃동네영업소,2466,712,703,9,2020
충북본부,엄정지사,동충주영업소,2116,704,641,63,2020
충북본부,엄정지사,북진천영업소,2849,915,863,52,2020
충북본부,엄정지사,서충주영업소,1119,449,373,76,2020
충북본부,엄정지사,엄정지사 교통안전팀,645,187,187,0,2020
충북본부,엄정지사,엄정지사 도로안전팀,476,145,145,0,2020
충북본부,엄정지사,음성영업소,1286,427,392,35,2020
충북본부,제천지사,남원주영업소,3916,1261,1190,71,2020
충북본부,제천지사,남제천영업소,4877,1803,1591,212,2020
충북본부,제천지사,단양영업소,3528,1763,1302,461,2020
충북본부,제천지사,북단양영업소,8911,4226,3241,985,2020
충북본부,제천지사,신림영업소,3444,1429,1187,242,2020
충북본부,제천지사,제천영업소,8584,2811,2689,122,2020
충북본부,제천지사,제천지사 고객지원팀,3,1,1,0,2020
충북본부,제천지사,제천지사 도로안전팀,172,53,51,2,2020
충북본부,진천지사,남이천영업소,2630,940,855,85,2020
충북본부,진천지사,대소영업소,5709,1697,1693,4,2020
충북본부,진천지사,서청주영업소,21894,6924,6877,47,2020
충북본부,진천지사,오창영업소,7678,2389,2351,38,2020
충북본부,진천지사,일죽영업소,38574,11636,11566,70,2020
충북본부,진천지사,증평영업소,9549,3094,2962,132,2020
충북본부,진천지사,진천영업소,2018,605,583,22,2020
충북본부,진천지사,진천지사 도로안전팀,87,29,29,0,2020
충북본부,충주지사,감곡영업소,6924,2211,2114,97,2020
충북본부,충주지사,괴산영업소,1121,365,339,26,2020
충북본부,충주지사,북충주영업소,3538,1224,1086,138,2020
충북본부,충주지사,연풍영업소,2275,702,675,27,2020
충북본부,충주지사,충주영업소,3467,1059,1031,28,2020
충북본부,충주지사,충주지사 고객지원팀,45,15,15,0,2020
충북본부,충주지사,충주지사 교통안전팀,775,194,194,0,2020
충북본부,충주지사,충주지사 도로안전팀,1212,370,370,0,2020
한국도로공사,지역본부,광주전남본부,2,2,1,1,2020
한국도로공사,지역본부,대구경북본부,13,4,4,0,2020
한국도로공사,지역본부,대전충남본부,7,4,4,0,2020
한국도로공사,지역본부,부산경남본부,0,1,1,0,2020
한국도로공사,지역본부,수도권본부,27,9,9,0,2020
한국도로공사,지역본부,전북본부,16,5,5,0,2020
강원본부,강릉지사,강릉영업소,1324,135,133,2,2019
강원본부,강릉지사,강릉지사 도로안전팀,3,1,1,0,2019
강원본부,강릉지사,근덕영업소,238,94,77,17,2019
강원본부,강릉지사,남강릉영업소,128,32,31,1,2019
강원본부,강릉지사,남양양영업소,132,48,42,6,2019
강원본부,강릉지사,동해영업소,234,94,79,15,2019
강원본부,강릉지사,망상영업소,167,54,53,1,2019
강원본부,강릉지사,북강릉영업소,74,20,20,0,2019
강원본부,강릉지사,삼척영업소,120,54,41,13,2019
강원본부,강릉지사,옥계영업소,213,76,70,6,2019
강원본부,대관령지사,대관령영업소,332,84,84,0,2019
강원본부,대관령지사,대관령지사 도로안전팀,442,134,134,0,2019
강원본부,대관령지사,면온영업소,234,60,60,0,2019
강원본부,대관령지사,속사영업소,29,10,8,2,2019
강원본부,대관령지사,진부영업소,188,54,52,2,2019
강원본부,대관령지사,평창영업소,233,68,65,3,2019
강원본부,양양지사,내촌영업소,60,20,18,2,2019
강원본부,양양지사,북양양영업소,31,9,9,0,2019
강원본부,양양지사,서양양영업소,27,9,9,0,2019
강원본부,양양지사,속초영업소,100,36,34,2,2019
강원본부,양양지사,양양영업소,281,100,90,10,2019
강원본부,양양지사,양양지사 도로안전팀,35,9,9,0,2019
강원본부,양양지사,인제영업소,157,55,53,2,2019
강원본부,양양지사,하조대영업소,319,102,102,0,2019
강원본부,원주지사,둔내영업소,75,18,18,0,2019
강원본부,원주지사,문막영업소,901,309,297,12,2019
강원본부,원주지사,새말영업소,239,67,67,0,2019
강원본부,원주지사,여주영업소,321,101,95,6,2019
강원본부,원주지사,원주영업소,1136,388,378,10,2019
강원본부,이천지사,남여주영업소,155,53,48,5,2019
강원본부,이천지사,덕평영업소,734,261,236,25,2019
강원본부,이천지사,북여주영업소,155,73,52,21,2019
강원본부,이천지사,서여주영업소,113,58,38,20,2019
강원본부,이천지사,양지영업소,954,342,312,30,2019
강원본부,이천지사,양평영업소,205,68,68,0,2019
강원본부,이천지사,용인영업소,849,347,272,75,2019
강원본부,이천지사,이천영업소,816,258,252,6,2019
강원본부,춘천지사,강촌영업소,107,33,33,0,2019
강원본부,춘천지사,남양주영업소,270,87,86,1,2019
강원본부,춘천지사,남춘천영업소,101,26,26,0,2019
강원본부,춘천지사,덕소삼패영업소,145,119,65,54,2019
강원본부,춘천지사,동홍천영업소,218,66,66,0,2019
강원본부,춘천지사,서종영업소,32,16,11,5,2019
강원본부,춘천지사,설악영업소,388,125,125,0,2019
강원본부,춘천지사,조양영업소,58,15,15,0,2019
강원본부,춘천지사,화도영업소,642,219,206,13,2019
강원본부,홍천지사,북원주영업소,37,10,10,0,2019
강원본부,홍천지사,춘천영업소,342,106,102,4,2019
강원본부,홍천지사,홍천영업소,312,75,73,2,2019
강원본부,홍천지사,횡성영업소,192,109,70,39,2019
광주전남본부,광주전남본부 기술처,광주전남본부 교통팀,289,74,74,0,2019
광주전남본부,광주지사,광주영업소,672,204,197,7,2019
광주전남본부,광주지사,광주지사 도로안전팀,83,21,21,0,2019
광주전남본부,광주지사,담양영업소,172,49,47,2,2019
광주전남본부,광주지사,동광주영업소,562,168,162,6,2019
광주전남본부,광주지사,백양사영업소,149,38,38,0,2019
광주전남본부,광주지사,장성영업소,616,185,181,4,2019
광주전남본부,광주지사,창평영업소,290,75,75,0,2019
광주전남본부,구례지사,구례화엄사영업소,273,90,75,15,2019
광주전남본부,구례지사,동순천영업소,670,196,194,2,2019
광주전남본부,구례지사,북남원영업소,144,65,47,18,2019
광주전남본부,구례지사,서남원영업소,244,84,73,11,2019
광주전남본부,구례지사,오수영업소,145,63,49,14,2019
광주전남본부,구례지사,임실영업소,128,38,37,1,2019
광주전남본부,구례지사,황전영업소,197,59,54,5,2019
광주전남본부,남원지사,남원영업소,168,105,67,38,2019
광주전남본부,남원지사,남원지사 고객지원팀,2,2,1,1,2019
광주전남본부,남원지사,동남원영업소,214,62,56,6,2019
광주전남본부,남원지사,순창영업소,1109,292,286,6,2019
광주전남본부,남원지사,지리산영업소,95,31,30,1,2019
광주전남본부,담양지사,곡성영업소,78,22,21,1,2019
광주전남본부,담양지사,남고창영업소,98,42,34,8,2019
광주전남본부,담양지사,북광주영업소,631,178,170,8,2019
광주전남본부,담양지사,옥과영업소,735,210,196,14,2019
광주전남본부,담양지사,장성물류영업소,172,60,58,2,2019
광주전남본부,보성지사,강진무위사영업소,423,129,129,0,2019
광주전남본부,보성지사,보성지사 고흥영업소,489,155,155,0,2019
광주전남본부,보성지사,보성지사 남순천영업소,953,297,287,10,2019
광주전남본부,보성지사,보성지사 벌교영업소,412,133,132,1,2019
광주전남본부,보성지사,보성지사 보성영업소,417,134,130,4,2019
광주전남본부,보성지사,서영암영업소,470,145,144,1,2019
광주전남본부,보성지사,순천만영업소,453,138,138,0,2019
광주전남본부,보성지사,장흥영업소,219,69,69,0,2019
광주전남본부,순천지사,광양영업소,720,218,204,14,2019
광주전남본부,순천지사,동광양영업소,615,212,197,15,2019
광주전남본부,순천지사,서순천영업소,210,69,67,2,2019
광주전남본부,순천지사,석곡영업소,75,22,22,0,2019
광주전남본부,순천지사,송광사영업소,131,34,34,0,2019
광주전남본부,순천지사,순천영업소,758,253,221,32,2019
광주전남본부,순천지사,순천지사 도로안전팀,271,87,87,0,2019
광주전남본부,순천지사,승주영업소,157,53,47,6,2019
광주전남본부,순천지사,옥곡영업소,617,223,204,19,2019
광주전남본부,순천지사,진월영업소,1717,613,566,47,2019
광주전남본부,함평지사,나주영업소,154,56,48,8,2019
광주전남본부,함평지사,동광산영업소,737,207,199,8,2019
광주전남본부,함평지사,동함평영업소,223,85,69,16,2019
광주전남본부,함평지사,목포영업소,1330,388,376,12,2019
광주전남본부,함평지사,무안공항영업소,121,37,37,0,2019
광주전남본부,함평지사,무안영업소,338,97,97,0,2019
광주전남본부,함평지사,문평영업소,51,13,13,0,2019
광주전남본부,함평지사,서광산영업소,293,84,82,2,2019
광주전남본부,함평지사,영광영업소,187,65,61,4,2019
광주전남본부,함평지사,함평영업소,96,29,29,0,2019
광주전남본부,함평지사,함평지사 도로안전팀,3,1,1,0,2019
대구경북본부,고령지사,가조영업소,174,57,56,1,2019
대구경북본부,고령지사,거창영업소,251,89,78,11,2019
대구경북본부,고령지사,고령영업소,479,141,137,4,2019
대구경북본부,고령지사,동고령영업소,534,159,152,7,2019
대구경북본부,고령지사,함양영업소,208,65,62,3,2019
대구경북본부,고령지사,해인사영업소,127,40,38,2,2019
대구경북본부,구미지사,구미영업소,1108,315,308,7,2019
대구경북본부,구미지사,김천영업소,334,92,92,0,2019
대구경북본부,구미지사,남구미영업소,863,258,240,18,2019
대구경북본부,구미지사,동김천영업소,289,122,86,36,2019
대구경북본부,구미지사,왜관영업소,1165,401,344,57,2019
대구경북본부,구미지사,추풍령영업소,157,53,50,3,2019
대구경북본부,구미지사,칠곡물류영업소,548,194,177,17,2019
대구경북본부,군위지사,가산영업소,1006,293,279,14,2019
대구경북본부,군위지사,군위영업소,269,97,79,18,2019
대구경북본부,군위지사,군위지사 고객지원팀,4,1,1,0,2019
대구경북본부,군위지사,남대구영업소,1219,408,369,39,2019
대구경북본부,군위지사,다부영업소,640,168,166,2,2019
대구경북본부,군위지사,서대구영업소,2486,774,761,13,2019
대구경북본부,군위지사,의성영업소,794,230,230,0,2019
대구경북본부,군위지사,칠곡영업소,904,388,306,82,2019
대구경북본부,군위지사,화원옥포영업소,1077,284,282,2,2019
대구경북본부,대구경북본부 기술처,대구경북본부 교통팀,10,6,4,2,2019
대구경북본부,대구지사,건천영업소,570,194,175,19,2019
대구경북본부,대구지사,경산영업소,1019,303,303,0,2019
대구경북본부,대구지사,경주영업소,2206,642,630,12,2019
대구경북본부,대구지사,대구지사 고객지원팀,3,1,1,0,2019
대구경북본부,대구지사,북대구영업소,3226,1017,928,89,2019
대구경북본부,대구지사,영천영업소,522,161,161,0,2019
대구경북본부,성주지사,남김천영업소,420,157,124,33,2019
대구경북본부,성주지사,남성주영업소,423,114,113,1,2019
대구경북본부,성주지사,선산영업소,182,60,56,4,2019
대구경북본부,성주지사,성주영업소,279,88,85,3,2019
대구경북본부,성주지사,성주지사 도로안전팀,19,9,7,2,2019
대구경북본부,영주지사,남안동영업소,419,111,109,2,2019
대구경북본부,영주지사,서안동영업소,457,122,115,7,2019
대구경북본부,영주지사,영주영업소,362,117,109,8,2019
대구경북본부,영주지사,영주지사 도로안전팀,615,205,205,0,2019
대구경북본부,영주지사,예천영업소,23,5,5,0,2019
대구경북본부,영주지사,풍기영업소,248,70,65,5,2019
대구경북본부,영천지사,북영천영업소,397,115,114,1,2019
대구경북본부,영천지사,서포항영업소,344,101,97,4,2019
대구경북본부,영천지사,영천지사 도로안전팀,608,152,152,0,2019
대구경북본부,영천지사,청통와촌영업소,278,79,76,3,2019
대구경북본부,영천지사,팔공산영업소,464,132,129,3,2019
대구경북본부,영천지사,포항영업소,1181,402,371,31,2019
대구경북본부,청송지사,청송지사 동상주영업소,140,53,47,6,2019
대구경북본부,청송지사,청송지사 동안동영업소,241,107,81,26,2019
대구경북본부,청송지사,청송지사 동청송영양영업소,63,29,22,7,2019
대구경북본부,청송지사,청송지사 북의성영업소,99,36,31,5,2019
대구경북본부,청송지사,청송지사 서의성영업소,88,32,28,4,2019
대구경북본부,청송지사,청송지사 영덕영업소,225,103,80,23,2019
대구경북본부,청송지사,청송지사 청송영업소,200,73,67,6,2019
대전충남본부,공주지사,공주영업소,345,107,103,4,2019
대전충남본부,공주지사,남세종영업소,339,95,95,0,2019
대전충남본부,공주지사,마곡사영업소,46,18,16,2,2019
대전충남본부,공주지사,서세종영업소,428,122,116,6,2019
대전충남본부,공주지사,신양영업소,253,73,73,0,2019
대전충남본부,공주지사,예산영업소,828,240,238,2,2019
대전충남본부,공주지사,유구영업소,280,82,80,2,2019
대전충남본부,당진지사,고덕영업소,634,187,187,0,2019
대전충남본부,당진지사,당진영업소,1219,378,375,3,2019
대전충남본부,당진지사,당진지사 도로안전팀,339,69,69,0,2019
대전충남본부,당진지사,면천영업소,1076,376,325,51,2019
대전충남본부,당진지사,서산영업소,849,264,259,5,2019
대전충남본부,당진지사,송악영업소,2853,933,895,38,2019
대전충남본부,당진지사,해미영업소,984,281,280,1,2019
대전충남본부,당진지사,홍성영업소,1243,346,344,2,2019
대전충남본부,대전지사,남청주영업소,1885,505,495,10,2019
대전충남본부,대전지사,대전영업소,843,269,249,20,2019
대전충남본부,대전지사,북대전영업소,916,260,250,10,2019
대전충남본부,대전지사,신탄진영업소,2364,639,639,0,2019
대전충남본부,대전지사,유성영업소,528,148,146,2,2019
대전충남본부,대전충남본부 기술처,대전충남본부 교통팀,399,133,133,0,2019
대전충남본부,대전충남본부 기술처,대전충남본부 도로팀,3,1,1,0,2019
대전충남본부,부여지사,동서천영업소,257,77,77,0,2019
대전충남본부,부여지사,부여영업소,338,90,90,0,2019
대전충남본부,부여지사,부여지사 도로안전팀,9,3,3,0,2019
대전충남본부,부여지사,서공주영업소,300,92,91,1,2019
대전충남본부,부여지사,서부여영업소,225,72,71,1,2019
대전충남본부,부여지사,청양영업소,84,30,28,2,2019
대전충남본부,영동지사,금강영업소,144,43,43,0,2019
대전충남본부,영동지사,서대전영업소,442,143,137,6,2019
대전충남본부,영동지사,안영영업소,504,187,165,22,2019
대전충남본부,영동지사,영동영업소,173,51,51,0,2019
대전충남본부,영동지사,옥천영업소,566,188,178,10,2019
대전충남본부,영동지사,판암영업소,349,127,109,18,2019
대전충남본부,영동지사,황간영업소,86,32,27,5,2019
대전충남본부,천안지사,목천영업소,580,159,155,4,2019
대전충남본부,천안지사,북천안영업소,1306,410,404,6,2019
대전충남본부,천안지사,안성영업소,254,64,63,1,2019
대전충남본부,천안지사,천안영업소,958,304,300,4,2019
대전충남본부,천안지사,청주영업소,646,191,188,3,2019
부산경남본부,경주지사,남경주영업소,584,170,165,5,2019
부산경남본부,경주지사,남포항영업소,1665,564,513,51,2019
부산경남본부,경주지사,동경주영업소,385,194,139,55,2019
부산경남본부,경주지사,범서영업소,232,72,67,5,2019
부산경남본부,고성지사,고성영업소,130,45,38,7,2019
부산경남본부,고성지사,고성지사 도로안전팀,131,34,34,0,2019
부산경남본부,고성지사,동고성영업소,182,46,45,1,2019
부산경남본부,고성지사,북통영영업소,130,40,40,0,2019
부산경남본부,고성지사,연화산영업소,22,11,8,3,2019
부산경남본부,고성지사,통영영업소,793,235,232,3,2019
부산경남본부,부산경남본부 기술처,부산경남본부 교통팀,1230,410,410,0,2019
부산경남본부,산청지사,단성영업소,732,200,198,2,2019
부산경남본부,산청지사,산청영업소,497,131,130,1,2019
부산경남본부,산청지사,생초영업소,450,179,142,37,2019
부산경남본부,산청지사,서상영업소,331,125,106,19,2019
부산경남본부,산청지사,서진주영업소,1035,276,263,13,2019
부산경남본부,산청지사,지곡영업소,699,211,208,3,2019
부산경남본부,서울산지사,노포영업소,704,180,174,6,2019
부산경남본부,서울산지사,부산영업소,2539,847,748,99,2019
부산경남본부,서울산지사,서울산영업소,652,218,193,25,2019
부산경남본부,서울산지사,서울산지사 도로안전팀,3,1,1,0,2019
부산경남본부,서울산지사,양산영업소,1139,349,335,14,2019
부산경남본부,서울산지사,통도사영업소,705,213,209,4,2019
부산경남본부,서울산지사,활천영업소,231,72,72,0,2019
부산경남본부,양산지사,광재영업소,336,113,98,15,2019
부산경남본부,양산지사,남양산영업소,1860,534,507,27,2019
부산경남본부,양산지사,대동영업소,5318,1778,1640,138,2019
부산경남본부,양산지사,동김해영업소,1030,273,270,3,2019
부산경남본부,양산지사,물금영업소,1392,420,388,32,2019
부산경남본부,양산지사,북부산영업소,2788,897,867,30,2019
부산경남본부,양산지사,서김해영업소,809,254,234,20,2019
부산경남본부,양산지사,양산지사 고객지원팀,60,20,20,0,2019
부산경남본부,양산지사,진영영업소,412,139,130,9,2019
부산경남본부,울산지사,금정영업소,149,65,49,16,2019
부산경남본부,울산지사,기장일광영업소,550,176,159,17,2019
부산경남본부,울산지사,기장철마영업소,143,44,39,5,2019
부산경남본부,울산지사,동부산영업소,112,44,39,5,2019
부산경남본부,울산지사,문수영업소,297,102,94,8,2019
부산경남본부,울산지사,온양영업소,657,320,237,83,2019
부산경남본부,울산지사,울산영업소,913,325,307,18,2019
부산경남본부,울산지사,울산지사 도로안전팀,81,27,27,0,2019
부산경남본부,울산지사,장안영업소,427,145,136,9,2019
부산경남본부,울산지사,청량영업소,2430,853,788,65,2019
부산경남본부,울산지사,해운대송정영업소,1230,470,425,45,2019
부산경남본부,진주지사,곤양영업소,174,56,50,6,2019
부산경남본부,진주지사,군북영업소,492,165,148,17,2019
부산경남본부,진주지사,문산영업소,598,163,156,7,2019
부산경남본부,진주지사,사천영업소,1389,385,374,11,2019
부산경남본부,진주지사,장지영업소,262,85,77,8,2019
부산경남본부,진주지사,지수영업소,319,104,87,17,2019
부산경남본부,진주지사,진교영업소,189,50,49,1,2019
부산경남본부,진주지사,진성영업소,466,123,121,2,2019
부산경남본부,진주지사,진주영업소,1511,417,405,12,2019
부산경남본부,진주지사,축동영업소,113,31,31,0,2019
부산경남본부,진주지사,하동영업소,1450,441,420,21,2019
부산경남본부,진주지사,함안영업소,651,218,198,20,2019
부산경남본부,창녕지사,남지영업소,682,200,195,5,2019
부산경남본부,창녕지사,내서영업소,239,65,65,0,2019
부산경남본부,창녕지사,달성영업소,522,168,154,14,2019
부산경남본부,창녕지사,영산영업소,791,219,219,0,2019
부산경남본부,창녕지사,창녕영업소,482,138,135,3,2019
부산경남본부,창녕지사,칠서영업소,1358,416,385,31,2019
부산경남본부,창녕지사,칠원영업소,853,284,259,25,2019
부산경남본부,창녕지사,현풍영업소,1236,327,327,0,2019
부산경남본부,창원지사,가락영업소,1914,580,575,5,2019
부산경남본부,창원지사,동창원영업소,1732,456,450,6,2019
부산경남본부,창원지사,마산영업소,1556,408,401,7,2019
부산경남본부,창원지사,북창원영업소,643,198,184,14,2019
부산경남본부,창원지사,산인영업소,2932,812,780,32,2019
부산경남본부,창원지사,서부산영업소,1174,484,407,77,2019
부산경남본부,창원지사,장유영업소,882,252,243,9,2019
부산경남본부,창원지사,진례영업소,979,283,270,13,2019
부산경남본부,창원지사,창원지사 고객지원팀,107,35,35,0,2019
부산경남본부,창원지사,창원지사 교통안전팀,12,4,4,0,2019
부산경남본부,창원지사,창원지사 도로안전팀,1398,466,466,0,2019
수도권본부,경기광주지사,경기광주영업소,678,210,193,17,2019
수도권본부,경기광주지사,경기광주지사 도로안전팀,3,1,1,0,2019
수도권본부,경기광주지사,곤지암영업소,1629,448,436,12,2019
수도권본부,경기광주지사,동서울영업소,2717,858,764,94,2019
수도권본부,경기광주지사,서이천영업소,796,262,239,23,2019
수도권본부,경기광주지사,하남영업소,1985,645,595,50,2019
수도권본부,군포지사,군자영업소,1445,464,442,22,2019
수도권본부,군포지사,군포영업소,191,69,64,5,2019
수도권본부,군포지사,군포지사 도로안전팀,3335,834,834,0,2019
수도권본부,군포지사,동군포영업소,1538,408,408,0,2019
수도권본부,군포지사,동수원영업소,773,270,218,52,2019
수도권본부,군포지사,마성영업소,92,48,34,14,2019
수도권본부,군포지사,부곡영업소,521,148,144,4,2019
수도권본부,군포지사,북수원영업소,248,92,79,13,2019
수도권본부,군포지사,서안산영업소,1814,516,516,0,2019
수도권본부,군포지사,안산영업소,133,47,43,4,2019
수도권본부,동서울지사,구리남양주영업소,4069,1536,1320,216,2019
수도권본부,동서울지사,동서울지사 도로안전팀,215,55,54,1,2019
수도권본부,동서울지사,성남영업소,3709,1226,1106,120,2019
수도권본부,동서울지사,청계영업소,6072,1722,1663,59,2019
수도권본부,동서울지사,토평영업소,397,201,146,55,2019
수도권본부,수도권본부 기술처,수도권본부 교통팀,350,98,97,1,2019
수도권본부,수원지사,기흥동탄영업소,316,132,104,28,2019
수도권본부,수원지사,기흥영업소,172,70,59,11,2019
수도권본부,수원지사,서울영업소,26743,7943,7939,4,2019
수도권본부,수원지사,수원신갈영업소,2616,726,706,20,2019
수도권본부,수원지사,오산영업소,751,228,223,5,2019
수도권본부,수원지사,판교영업소,305,147,105,42,2019
수도권본부,시흥지사,남인천영업소,3698,1656,1335,321,2019
수도권본부,시흥지사,서서울영업소,14586,4409,3968,441,2019
수도권본부,시흥지사,시흥영업소,2971,1090,1014,76,2019
수도권본부,인천지사,김포영업소,7963,3422,2699,723,2019
수도권본부,인천지사,인천영업소,7929,3883,2878,1005,2019
수도권본부,인천지사,인천지사 도로안전팀,1431,477,477,0,2019
수도권본부,화성지사,남안성영업소,1123,330,328,2,2019
수도권본부,화성지사,매송영업소,1212,364,364,0,2019
수도권본부,화성지사,발안영업소,486,154,149,5,2019
수도권본부,화성지사,비봉영업소,806,227,227,0,2019
수도권본부,화성지사,서안성영업소,1839,544,529,15,2019
수도권본부,화성지사,서평택영업소,1173,349,349,0,2019
수도권본부,화성지사,송탄영업소,904,289,278,11,2019
수도권본부,화성지사,청북영업소,2110,592,592,0,2019
수도권본부,화성지사,평택고덕영업소,74,31,22,9,2019
수도권본부,화성지사,평택영업소,2385,690,670,20,2019
전북본부,논산지사,계룡영업소,250,69,69,0,2019
전북본부,논산지사,논산영업소,401,118,115,3,2019
전북본부,논산지사,완주영업소,1296,361,357,4,2019
전북본부,논산지사,익산영업소,844,240,240,0,2019
전북본부,무주지사,금산영업소,60,25,20,5,2019
전북본부,무주지사,남대전영업소,526,150,142,8,2019
전북본부,무주지사,덕유산영업소,75,29,26,3,2019
전북본부,무주지사,무주영업소,217,69,64,5,2019
전북본부,무주지사,무주지사 도로안전팀,151,54,41,13,2019
전북본부,무주지사,추부영업소,161,46,44,2,2019
전북본부,보령지사,광천영업소,682,212,204,8,2019
전북본부,보령지사,군산영업소,527,163,163,0,2019
전북본부,보령지사,대천영업소,272,72,70,2,2019
전북본부,보령지사,무창포영업소,133,47,40,7,2019
전북본부,보령지사,서천영업소,260,68,68,0,2019
전북본부,보령지사,춘장대영업소,56,17,17,0,2019
전북본부,부안지사,고창영업소,364,123,120,3,2019
전북본부,부안지사,동군산영업소,1012,269,268,1,2019
전북본부,부안지사,부안영업소,256,76,76,0,2019
전북본부,부안지사,서김제영업소,238,72,72,0,2019
전북본부,부안지사,선운산영업소,940,271,265,6,2019
전북본부,부안지사,줄포영업소,157,47,47,0,2019
전북본부,전주지사,금산사영업소,74,24,23,1,2019
전북본부,전주지사,김제영업소,168,53,48,5,2019
전북본부,전주지사,내장산영업소,34,10,10,0,2019
전북본부,전주지사,삼례영업소,311,89,88,1,2019
전북본부,전주지사,서전주영업소,392,110,109,1,2019
전북본부,전주지사,전주영업소,517,153,153,0,2019
전북본부,전주지사,전주지사 고객지원팀,3,1,1,0,2019
전북본부,전주지사,전주지사 교통안전팀,3,1,1,0,2019
전북본부,전주지사,전주지사 도로안전팀,663,221,221,0,2019
전북본부,전주지사,정읍영업소,366,103,103,0,2019
전북본부,전주지사,태인영업소,261,74,73,1,2019
전북본부,진안지사,동전주영업소,15,5,5,0,2019
전북본부,진안지사,상관영업소,101,35,33,2,2019
전북본부,진안지사,소양영업소,129,43,38,5,2019
전북본부,진안지사,장수영업소,118,38,34,4,2019
전북본부,진안지사,진안영업소,107,32,31,1,2019
지역본부,강원본부,강릉지사,630,210,210,0,2019
지역본부,강원본부,대관령지사,3,1,1,0,2019
지역본부,강원본부,양양지사,156,22,22,0,2019
지역본부,강원본부,춘천지사,5,3,2,1,2019
지역본부,강원본부,홍천지사,132,33,33,0,2019
지역본부,광주전남본부,남원지사,720,240,240,0,2019
지역본부,광주전남본부,함평지사,2,2,1,1,2019
지역본부,대구경북본부,성주지사,35,14,10,4,2019
지역본부,대구경북본부,청송지사,7,5,3,2,2019
지역본부,부산경남본부,진주지사,1002,334,334,0,2019
지역본부,부산경남본부,창원지사,12,3,3,0,2019
지역본부,수도권본부,경기광주지사,1651,456,456,0,2019
지역본부,수도권본부,군포지사,1505,377,377,0,2019
지역본부,수도권본부,수도권본부 기술처,3,1,1,0,2019
지역본부,수도권본부,수도권본부 기술처,3,1,1,0,2019
지역본부,수도권본부,수원지사,805,0,0,0,2019
지역본부,수도권본부,인천지사,72,24,24,0,2019
지역본부,전북본부,논산지사,3,1,1,0,2019
지역본부,전북본부,보령지사,7,2,2,0,2019
지역본부,전북본부,부안지사,3,1,1,0,2019
지역본부,전북본부,전주지사,345,115,115,0,2019
지역본부,전북본부,진안지사,4,1,1,0,2019
지역본부,충북본부,상주지사,120,40,40,0,2019
지역본부,충북본부,제천지사,26,6,6,0,2019
지역본부,충북본부,충주지사,18,6,6,0,2019
충북본부,보은지사,남상주영업소,253,89,82,7,2019
충북본부,보은지사,문의영업소,464,144,133,11,2019
충북본부,보은지사,보은영업소,295,125,97,28,2019
충북본부,보은지사,보은지사 도로안전팀,234,78,78,0,2019
충북본부,보은지사,보은지사 도로안전팀,234,78,78,0,2019
충북본부,보은지사,속리산영업소,118,36,35,1,2019
충북본부,보은지사,화서영업소,211,72,65,7,2019
충북본부,보은지사,회인영업소,91,29,28,1,2019
충북본부,상주지사,문경새재영업소,182,51,51,0,2019
충북본부,상주지사,북상주영업소,272,79,77,2,2019
충북본부,상주지사,상주영업소,179,62,57,5,2019
충북본부,상주지사,점촌함창영업소,332,97,92,5,2019
충북본부,엄정지사,금왕꽃동네영업소,300,85,85,0,2019
충북본부,엄정지사,동충주영업소,288,83,79,4,2019
충북본부,엄정지사,북진천영업소,516,152,149,3,2019
충북본부,엄정지사,서충주영업소,204,101,73,28,2019
충북본부,엄정지사,엄정지사 교통안전팀,69,23,23,0,2019
충북본부,엄정지사,엄정지사 도로안전팀,476,145,145,0,2019
충북본부,엄정지사,엄정지사 도로안전팀,476,145,145,0,2019
충북본부,엄정지사,음성영업소,273,107,90,17,2019
충북본부,제천지사,남원주영업소,641,201,191,10,2019
충북본부,제천지사,남제천영업소,1055,406,348,58,2019
충북본부,제천지사,단양영업소,371,229,149,80,2019
충북본부,제천지사,북단양영업소,420,208,153,55,2019
충북본부,제천지사,신림영업소,371,163,133,30,2019
충북본부,제천지사,제천영업소,859,271,255,16,2019
충북본부,제천지사,제천지사 도로안전팀,4,1,1,0,2019
충북본부,진천지사,남이천영업소,682,256,232,24,2019
충북본부,진천지사,대소영업소,153,40,40,0,2019
충북본부,진천지사,서청주영업소,1371,389,384,5,2019
충북본부,진천지사,오창영업소,974,298,290,8,2019
충북본부,진천지사,일죽영업소,7728,2255,2239,16,2019
충북본부,진천지사,증평영업소,695,214,208,6,2019
충북본부,진천지사,진천영업소,817,263,245,18,2019
충북본부,진천지사,진천지사 도로안전팀,87,29,29,0,2019
충북본부,진천지사,진천지사 도로안전팀,87,29,29,0,2019
충북본부,충주지사,감곡영업소,397,143,131,12,2019
충북본부,충주지사,괴산영업소,88,26,25,1,2019
충북본부,충주지사,북충주영업소,262,95,80,15,2019
충북본부,충주지사,연풍영업소,126,46,42,4,2019
충북본부,충주지사,충주영업소,89,24,24,0,2019
충북본부,충주지사,충주지사 고객지원팀,45,15,15,0,2019
충북본부,충주지사,충주지사 고객지원팀,45,15,15,0,2019
충북본부,충주지사,충주지사 교통안전팀,3,1,1,0,2019
충북본부,충주지사,충주지사 교통안전팀,3,1,1,0,2019
충북본부,충주지사,충주지사 도로안전팀,1208,369,369,0,2019
한국도로공사,지역본부,대구경북본부,4,1,1,0,2019
한국도로공사,지역본부,대전충남본부,6,2,2,0,2019
한국도로공사,지역본부,수도권본부,9,3,3,0,2019
한국도로공사,지역본부,전북본부,4,1,1,0,2019
지역본부,부산경남본부,울산지사,174,795,795,0,2019
지역본부,부산경남본부,진주지사,11938,4284,3960,324,2019
지역본부,부산경남본부,창녕지사,11,1659,1659,0,2019
지역본부,부산경남본부,창원지사,3627,4505,4504,1,2019
지역본부,수도권본부,경기광주지사,13642,4253,4250,3,2019
지역본부,수도권본부,군포지사,20355,5555,5553,2,2019
지역본부,수도권본부,동서울지사,8058,1900,1823,77,2019
지역본부,수도권본부,수도권본부 관리처,193,63,62,1,2019
지역본부,수도권본부,수원지사,3381,388,388,0,2019
지역본부,수도권본부,시흥지사,28141,8599,8599,0,2019
지역본부,수도권본부,인천지사,47033,15349,15153,196,2019
지역본부,수도권본부,화성지사,3946,1315,1315,0,2019
지역본부,전북본부,논산지사,324,108,107,1,2019
지역본부,전북본부,무주지사,1385,455,453,2,2019
지역본부,전북본부,보령지사,14,462,462,0,2019
지역본부,전북본부,부안지사,7151,2347,2347,0,2019
지역본부,전북본부,전북본부 기술처,35,9,9,0,2019
지역본부,전북본부,전주지사,5194,1692,1692,0,2019
지역본부,전북본부,진안지사,550,183,183,0,2019
지역본부,충북본부,보은지사,685,175,175,0,2019
지역본부,충북본부,상주지사,3098,1016,1001,15,2019
지역본부,충북본부,엄정지사,955,307,307,0,2019
지역본부,충북본부,제천지사,1924,634,589,45,2019
지역본부,충북본부,진천지사,499,165,165,0,2019
지역본부,충북본부,충주지사,4673,1511,1511,0,2019
충북본부,보은지사,남상주영업소,4350,1465,1390,75,2019
충북본부,보은지사,문의영업소,5186,1640,1602,38,2019
충북본부,보은지사,보은영업소,2379,826,740,86,2019
충북본부,보은지사,속리산영업소,3506,1099,1087,12,2019
충북본부,보은지사,화서영업소,2447,829,788,41,2019
충북본부,보은지사,회인영업소,1690,567,552,15,2019
충북본부,상주지사,문경새재영업소,2271,685,674,11,2019
충북본부,상주지사,북상주영업소,5562,1756,1716,40,2019
충북본부,상주지사,상주영업소,4304,1437,1362,75,2019
충북본부,상주지사,점촌함창영업소,4391,1363,1319,44,2019
충북본부,엄정지사,금왕꽃동네영업소,2250,645,639,6,2019
충북본부,엄정지사,동충주영업소,1775,600,538,62,2019
충북본부,엄정지사,북진천영업소,2513,816,765,51,2019
충북본부,엄정지사,서충주영업소,906,379,309,70,2019
충북본부,엄정지사,엄정지사 교통안전팀,201,67,67,0,2019
충북본부,엄정지사,음성영업소,1055,365,330,35,2019
충북본부,제천지사,남원주영업소,3869,1252,1182,70,2019
충북본부,제천지사,남제천영업소,4650,1720,1518,202,2019
충북본부,제천지사,단양영업소,3481,1734,1283,451,2019
충북본부,제천지사,북단양영업소,8801,4184,3204,980,2019
충북본부,제천지사,신림영업소,3379,1406,1165,241,2019
충북본부,제천지사,제천영업소,8463,2756,2645,111,2019
충북본부,제천지사,제천지사 고객지원팀,3,1,1,0,2019
충북본부,제천지사,제천지사 교통안전팀,30,10,10,0,2019
충북본부,제천지사,제천지사 도로안전팀,172,53,51,2,2019
충북본부,진천지사,남이천영업소,2306,836,753,83,2019
충북본부,진천지사,대소영업소,5520,1645,1641,4,2019
충북본부,진천지사,서청주영업소,21832,6906,6859,47,2019
충북본부,진천지사,오창영업소,7611,2369,2331,38,2019
충북본부,진천지사,일죽영업소,37984,11466,11399,67,2019
충북본부,진천지사,증평영업소,9267,3009,2878,131,2019
충북본부,진천지사,진천영업소,1709,526,504,22,2019
충북본부,진천지사,진천지사 교통안전팀,57,19,19,0,2019
충북본부,충주지사,감곡영업소,6665,2137,2042,95,2019
충북본부,충주지사,괴산영업소,1037,345,319,26,2019
충북본부,충주지사,북충주영업소,3485,1201,1069,132,2019
충북본부,충주지사,연풍영업소,2208,677,655,22,2019
충북본부,충주지사,충주영업소,3397,1045,1017,28,2019
충북본부,충주지사,충주지사 도로안전팀,1212,370,370,0,2019
한국도로공사,지역본부,광주전남본부,2,2,1,1,2019
한국도로공사,지역본부,대구경북본부,10,3,3,0,2019
한국도로공사,지역본부,대전충남본부,7,4,4,0,2019
한국도로공사,지역본부,부산경남본부,0,1,1,0,2019
한국도로공사,지역본부,수도권본부,21,7,7,0,2019
한국도로공사,지역본부,전북본부,16,5,5,0,2019
강원본부,강릉지사,강릉영업소,688,164,162,2,2018
강원본부,강릉지사,근덕영업소,243,133,90,43,2018
강원본부,강릉지사,남강릉영업소,96,32,28,4,2018
강원본부,강릉지사,남양양영업소,170,63,50,13,2018
강원본부,강릉지사,동해영업소,145,75,53,22,2018
강원본부,강릉지사,망상영업소,58,16,16,0,2018
강원본부,강릉지사,북강릉영업소,55,13,13,0,2018
강원본부,강릉지사,삼척영업소,52,32,19,13,2018
강원본부,강릉지사,옥계영업소,151,57,43,14,2018
강원본부,대관령지사,대관령영업소,64,8,4,4,2018
강원본부,대관령지사,대관령지사 교통안전팀,750,214,214,0,2018
강원본부,대관령지사,면온영업소,10,3,3,0,2018
강원본부,대관령지사,속사영업소,57,18,14,4,2018
강원본부,대관령지사,진부영업소,81,25,22,3,2018
강원본부,대관령지사,평창영업소,90,60,36,24,2018
강원본부,양양지사,내촌영업소,78,26,26,0,2018
강원본부,양양지사,북양양영업소,98,30,29,1,2018
강원본부,양양지사,서양양영업소,18,6,6,0,2018
강원본부,양양지사,속초영업소,217,75,71,4,2018
강원본부,양양지사,양양영업소,89,39,31,8,2018
강원본부,양양지사,인제영업소,81,27,27,0,2018
강원본부,양양지사,하조대영업소,138,70,52,18,2018
강원본부,원주지사,둔내영업소,72,16,16,0,2018
강원본부,원주지사,문막영업소,512,164,160,4,2018
강원본부,원주지사,새말영업소,140,40,38,2,2018
강원본부,원주지사,여주영업소,594,193,192,1,2018
강원본부,원주지사,원주영업소,1162,362,362,0,2018
강원본부,이천지사,남여주영업소,340,112,100,12,2018
강원본부,이천지사,덕평영업소,605,228,199,29,2018
강원본부,이천지사,북여주영업소,267,93,83,10,2018
강원본부,이천지사,서여주영업소,151,46,42,4,2018
강원본부,이천지사,양지영업소,1016,299,271,28,2018
강원본부,이천지사,양평영업소,200,72,68,4,2018
강원본부,이천지사,용인영업소,772,295,248,47,2018
강원본부,이천지사,이천영업소,368,124,122,2,2018
강원본부,춘천지사,강촌영업소,58,19,19,0,2018
강원본부,춘천지사,남양주영업소,407,141,133,8,2018
강원본부,춘천지사,남춘천영업소,45,15,14,1,2018
강원본부,춘천지사,덕소삼패영업소,237,83,80,3,2018
강원본부,춘천지사,동홍천영업소,105,36,35,1,2018
강원본부,춘천지사,서종영업소,29,11,10,1,2018
강원본부,춘천지사,설악영업소,279,93,93,0,2018
강원본부,춘천지사,조양영업소,34,11,11,0,2018
강원본부,춘천지사,화도영업소,358,122,120,2,2018
강원본부,홍천지사,북원주영업소,56,13,12,1,2018
강원본부,홍천지사,춘천영업소,328,84,77,7,2018
강원본부,홍천지사,홍천영업소,189,59,56,3,2018
강원본부,홍천지사,횡성영업소,359,135,111,24,2018
광주전남본부,광주전남본부 기술처,광주전남본부 교통팀,167,61,56,5,2018
광주전남본부,광주지사,광주영업소,2427,792,779,13,2018
광주전남본부,광주지사,담양영업소,563,186,185,1,2018
광주전남본부,광주지사,동광주영업소,1729,555,541,14,2018
광주전남본부,광주지사,백양사영업소,764,257,255,2,2018
광주전남본부,광주지사,장성영업소,1406,466,463,3,2018
광주전남본부,광주지사,창평영업소,353,115,115,0,2018
광주전남본부,구례지사,구례화엄사영업소,258,90,87,3,2018
광주전남본부,구례지사,동순천영업소,719,241,239,2,2018
광주전남본부,구례지사,북남원영업소,135,49,45,4,2018
광주전남본부,구례지사,서남원영업소,195,89,71,18,2018
광주전남본부,구례지사,오수영업소,381,159,134,25,2018
광주전남본부,구례지사,임실영업소,113,35,35,0,2018
광주전남본부,구례지사,황전영업소,149,51,49,2,2018
광주전남본부,남원지사,남원영업소,303,101,100,1,2018
광주전남본부,남원지사,동남원영업소,21,11,8,3,2018
광주전남본부,남원지사,순창영업소,229,79,75,4,2018
광주전남본부,남원지사,지리산영업소,40,12,11,1,2018
광주전남본부,담양지사,곡성영업소,445,155,144,11,2018
광주전남본부,담양지사,남고창영업소,621,211,207,4,2018
광주전남본부,담양지사,북광주영업소,1356,448,448,0,2018
광주전남본부,담양지사,옥과영업소,682,235,225,10,2018
광주전남본부,담양지사,장성물류영업소,212,61,61,0,2018
광주전남본부,보성지사,강진무위사영업소,742,239,238,1,2018
광주전남본부,보성지사,보성지사 고흥영업소,906,299,298,1,2018
광주전남본부,보성지사,보성지사 남순천영업소,1649,527,524,3,2018
광주전남본부,보성지사,보성지사 벌교영업소,938,314,309,5,2018
광주전남본부,보성지사,보성지사 보성영업소,1158,378,378,0,2018
광주전남본부,보성지사,서영암영업소,850,269,269,0,2018
광주전남본부,보성지사,순천만영업소,661,175,174,1,2018
광주전남본부,보성지사,장흥영업소,322,106,106,0,2018
광주전남본부,순천지사,광양영업소,750,265,249,16,2018
광주전남본부,순천지사,동광양영업소,505,167,163,4,2018
광주전남본부,순천지사,서순천영업소,291,104,97,7,2018
광주전남본부,순천지사,석곡영업소,27,9,9,0,2018
광주전남본부,순천지사,송광사영업소,201,67,67,0,2018
광주전남본부,순천지사,순천영업소,475,174,159,15,2018
광주전남본부,순천지사,승주영업소,154,54,52,2,2018
광주전남본부,순천지사,옥곡영업소,503,184,171,13,2018
광주전남본부,순천지사,진월영업소,1560,542,524,18,2018
광주전남본부,함평지사,나주영업소,679,225,222,3,2018
광주전남본부,함평지사,동광산영업소,6039,2008,1974,34,2018
광주전남본부,함평지사,동함평영업소,938,316,312,4,2018
광주전남본부,함평지사,목포영업소,4415,1443,1432,11,2018
광주전남본부,함평지사,무안공항영업소,727,239,238,1,2018
광주전남본부,함평지사,무안영업소,662,220,216,4,2018
광주전남본부,함평지사,문평영업소,748,277,256,21,2018
광주전남본부,함평지사,서광산영업소,1406,459,459,0,2018
광주전남본부,함평지사,영광영업소,687,221,219,2,2018
광주전남본부,함평지사,함평영업소,440,145,145,0,2018
대구경북본부,고령지사,가조영업소,132,41,41,0,2018
대구경북본부,고령지사,거창영업소,276,107,87,20,2018
대구경북본부,고령지사,고령영업소,635,228,203,25,2018
대구경북본부,고령지사,동고령영업소,747,290,243,47,2018
대구경북본부,고령지사,함양영업소,187,62,61,1,2018
대구경북본부,고령지사,해인사영업소,267,100,90,10,2018
대구경북본부,구미지사,구미영업소,369,115,115,0,2018
대구경북본부,구미지사,김천영업소,337,115,110,5,2018
대구경북본부,구미지사,남구미영업소,780,239,238,1,2018
대구경북본부,구미지사,동김천영업소,441,175,144,31,2018
대구경북본부,구미지사,왜관영업소,2394,859,791,68,2018
대구경북본부,구미지사,추풍령영업소,85,28,28,0,2018
대구경북본부,구미지사,칠곡물류영업소,510,169,156,13,2018
대구경북본부,군위지사,가산영업소,682,217,205,12,2018
대구경북본부,군위지사,군위영업소,213,59,52,7,2018
대구경북본부,군위지사,남대구영업소,1394,581,401,180,2018
대구경북본부,군위지사,다부영업소,378,127,105,22,2018
대구경북본부,군위지사,서대구영업소,1711,587,527,60,2018
대구경북본부,군위지사,의성영업소,257,75,74,1,2018
대구경북본부,군위지사,칠곡영업소,495,197,165,32,2018
대구경북본부,군위지사,화원옥포영업소,630,215,192,23,2018
대구경북본부,대구경북본부 관리처,대구경북본부 영업팀,2,2,1,1,2018
대구경북본부,대구경북본부 기술처,대구경북본부 교통팀,102,38,34,4,2018
대구경북본부,대구지사,건천영업소,841,301,270,31,2018
대구경북본부,대구지사,경산영업소,835,210,208,2,2018
대구경북본부,대구지사,경주영업소,1074,342,322,20,2018
대구경북본부,대구지사,대구지사 남칠곡영업소,1257,23,22,1,2018
대구경북본부,대구지사,대구지사 다사영업소,3,1,1,0,2018
대구경북본부,대구지사,대구지사 동명동호영업소,158,2,2,0,2018
대구경북본부,대구지사,대구지사 둔산영업소,58,16,16,0,2018
대구경북본부,대구지사,대구지사 북다사영업소,182,54,50,4,2018
대구경북본부,대구지사,대구지사 북달성영업소,344,16,14,2,2018
대구경북본부,대구지사,대구지사 연경영업소,344,41,38,3,2018
대구경북본부,대구지사,대구지사 율암영업소,96,24,24,0,2018
대구경북본부,대구지사,대구지사 지천영업소,81,19,15,4,2018
대구경북본부,대구지사,대구지사 파군재영업소,99,27,26,1,2018
대구경북본부,대구지사,북대구영업소,696,355,247,108,2018
대구경북본부,대구지사,영천영업소,436,140,137,3,2018
대구경북본부,성주지사,남김천영업소,372,166,124,42,2018
대구경북본부,성주지사,남성주영업소,287,101,90,11,2018
대구경북본부,성주지사,선산영업소,276,92,89,3,2018
대구경북본부,성주지사,성주영업소,428,164,129,35,2018
대구경북본부,성주지사,성주지사 교통안전팀,112,12,12,0,2018
대구경북본부,영주지사,남안동영업소,394,106,104,2,2018
대구경북본부,영주지사,서안동영업소,319,97,94,3,2018
대구경북본부,영주지사,영주영업소,445,138,130,8,2018
대구경북본부,영주지사,영주지사 교통안전팀,678,226,226,0,2018
대구경북본부,영주지사,예천영업소,56,20,18,2,2018
대구경북본부,영주지사,풍기영업소,302,89,85,4,2018
대구경북본부,영천지사,북영천영업소,313,99,96,3,2018
대구경북본부,영천지사,서포항영업소,487,180,151,29,2018
대구경북본부,영천지사,청통와촌영업소,437,128,124,4,2018
대구경북본부,영천지사,팔공산영업소,616,201,182,19,2018
대구경북본부,영천지사,포항영업소,896,266,250,16,2018
대구경북본부,청송지사,청송지사 동상주영업소,147,63,48,15,2018
대구경북본부,청송지사,청송지사 동안동영업소,319,137,109,28,2018
대구경북본부,청송지사,청송지사 동청송영양영업소,140,53,43,10,2018
대구경북본부,청송지사,청송지사 북의성영업소,229,71,71,0,2018
대구경북본부,청송지사,청송지사 서의성영업소,217,71,66,5,2018
대구경북본부,청송지사,청송지사 영덕영업소,765,273,244,29,2018
대구경북본부,청송지사,청송지사 청송영업소,174,62,53,9,2018
대전충남본부,공주지사,공주영업소,375,122,120,2,2018
대전충남본부,공주지사,남세종영업소,810,225,207,18,2018
대전충남본부,공주지사,마곡사영업소,171,52,51,1,2018
대전충남본부,공주지사,서세종영업소,664,220,218,2,2018
대전충남본부,공주지사,신양영업소,202,61,61,0,2018
대전충남본부,공주지사,예산영업소,659,197,197,0,2018
대전충남본부,공주지사,유구영업소,177,52,52,0,2018
대전충남본부,당진지사,고덕영업소,330,96,96,0,2018
대전충남본부,당진지사,당진영업소,1360,419,408,11,2018
대전충남본부,당진지사,면천영업소,350,103,99,4,2018
대전충남본부,당진지사,서산영업소,2637,750,750,0,2018
대전충남본부,당진지사,송악영업소,3047,878,873,5,2018
대전충남본부,당진지사,해미영업소,510,142,136,6,2018
대전충남본부,당진지사,홍성영업소,964,270,270,0,2018
대전충남본부,대전지사,남청주영업소,819,264,258,6,2018
대전충남본부,대전지사,대전영업소,955,290,275,15,2018
대전충남본부,대전지사,북대전영업소,1449,453,450,3,2018
대전충남본부,대전지사,신탄진영업소,994,309,303,6,2018
대전충남본부,대전지사,유성영업소,1542,448,435,13,2018
대전충남본부,부여지사,동서천영업소,543,169,169,0,2018
대전충남본부,부여지사,부여영업소,176,60,57,3,2018
대전충남본부,부여지사,서공주영업소,237,71,71,0,2018
대전충남본부,부여지사,서부여영업소,301,99,99,0,2018
대전충남본부,부여지사,청양영업소,111,27,27,0,2018
대전충남본부,영동지사,금강영업소,166,55,55,0,2018
대전충남본부,영동지사,서대전영업소,1941,629,621,8,2018
대전충남본부,영동지사,안영영업소,244,97,78,19,2018
대전충남본부,영동지사,영동영업소,273,90,89,1,2018
대전충남본부,영동지사,옥천영업소,524,159,159,0,2018
대전충남본부,영동지사,판암영업소,591,188,174,14,2018
대전충남본부,영동지사,황간영업소,259,81,80,1,2018
대전충남본부,천안지사,목천영업소,1608,515,507,8,2018
대전충남본부,천안지사,북천안영업소,1268,396,377,19,2018
대전충남본부,천안지사,안성영업소,819,256,255,1,2018
대전충남본부,천안지사,천안영업소,3787,1173,1170,3,2018
대전충남본부,천안지사,청주영업소,793,243,239,4,2018
부산경남본부,경주지사,경주지사 교통안전팀,848,280,280,0,2018
부산경남본부,경주지사,남경주영업소,621,170,166,4,2018
부산경남본부,경주지사,남포항영업소,1597,485,459,26,2018
부산경남본부,경주지사,동경주영업소,394,157,135,22,2018
부산경남본부,경주지사,범서영업소,344,99,93,6,2018
부산경남본부,고성지사,고성영업소,967,311,306,5,2018
부산경남본부,고성지사,동고성영업소,822,257,256,1,2018
부산경남본부,고성지사,북통영영업소,647,210,210,0,2018
부산경남본부,고성지사,연화산영업소,260,78,78,0,2018
부산경남본부,고성지사,통영영업소,660,206,204,2,2018
부산경남본부,부산경남본부 기술처,부산경남본부 교통팀,114,38,38,0,2018
부산경남본부,산청지사,단성영업소,943,306,303,3,2018
부산경남본부,산청지사,산청영업소,299,99,93,6,2018
부산경남본부,산청지사,생초영업소,533,171,170,1,2018
부산경남본부,산청지사,서상영업소,667,197,196,1,2018
부산경남본부,산청지사,서진주영업소,996,321,316,5,2018
부산경남본부,산청지사,지곡영업소,1236,403,403,0,2018
부산경남본부,서울산지사,노포영업소,1074,288,287,1,2018
부산경남본부,서울산지사,부산영업소,3536,1055,993,62,2018
부산경남본부,서울산지사,서울산영업소,1185,331,324,7,2018
부산경남본부,서울산지사,서울산지사 교통안전팀,1095,281,281,0,2018
부산경남본부,서울산지사,서울산지사 배내골영업소,427,139,139,0,2018
부산경남본부,서울산지사,양산영업소,2150,568,565,3,2018
부산경남본부,서울산지사,통도사영업소,646,173,170,3,2018
부산경남본부,서울산지사,활천영업소,624,203,194,9,2018
부산경남본부,양산지사,광재영업소,938,265,258,7,2018
부산경남본부,양산지사,남양산영업소,1473,436,419,17,2018
부산경남본부,양산지사,대동영업소,5189,1835,1541,294,2018
부산경남본부,양산지사,동김해영업소,660,202,194,8,2018
부산경남본부,양산지사,물금영업소,1115,339,334,5,2018
부산경남본부,양산지사,북부산영업소,2092,600,570,30,2018
부산경남본부,양산지사,서김해영업소,652,191,188,3,2018
부산경남본부,양산지사,양산지사 교통안전팀,3014,1010,1006,4,2018
부산경남본부,양산지사,양산지사 한림영업소,244,66,64,2,2018
부산경남본부,양산지사,진영영업소,1511,411,401,10,2018
부산경남본부,울산지사,금정영업소,545,161,159,2,2018
부산경남본부,울산지사,기장일광영업소,1147,388,369,19,2018
부산경남본부,울산지사,기장일광영업소(재정),20,0,0,0,2018
부산경남본부,울산지사,기장철마영업소,1156,365,358,7,2018
부산경남본부,울산지사,동부산영업소,504,149,138,11,2018
부산경남본부,울산지사,문수영업소,494,163,150,13,2018
부산경남본부,울산지사,온양영업소,326,104,97,7,2018
부산경남본부,울산지사,울산영업소,2153,723,616,107,2018
부산경남본부,울산지사,울산지사 교통안전팀,5005,603,603,0,2018
부산경남본부,울산지사,장안영업소,502,179,153,26,2018
부산경남본부,울산지사,청량영업소,3242,1032,988,44,2018
부산경남본부,울산지사,해운대송정영업소,2046,665,608,57,2018
부산경남본부,진주지사,곤양영업소,1227,407,404,3,2018
부산경남본부,진주지사,군북영업소,2045,653,652,1,2018
부산경남본부,진주지사,문산영업소,535,169,168,1,2018
부산경남본부,진주지사,사천영업소,5215,1689,1684,5,2018
부산경남본부,진주지사,장지영업소,1869,596,595,1,2018
부산경남본부,진주지사,지수영업소,486,150,150,0,2018
부산경남본부,진주지사,진교영업소,759,246,246,0,2018
부산경남본부,진주지사,진성영업소,846,271,270,1,2018
부산경남본부,진주지사,진주영업소,3842,1242,1236,6,2018
부산경남본부,진주지사,축동영업소,810,261,261,0,2018
부산경남본부,진주지사,하동영업소,1358,460,449,11,2018
부산경남본부,진주지사,함안영업소,2677,887,880,7,2018
부산경남본부,창녕지사,남지영업소,368,124,119,5,2018
부산경남본부,창녕지사,내서영업소,673,223,223,0,2018
부산경남본부,창녕지사,달성영업소,398,120,120,0,2018
부산경남본부,창녕지사,영산영업소,597,181,181,0,2018
부산경남본부,창녕지사,창녕영업소,1161,373,373,0,2018
부산경남본부,창녕지사,칠서영업소,1360,424,415,9,2018
부산경남본부,창녕지사,칠원영업소,1589,487,451,36,2018
부산경남본부,창녕지사,현풍영업소,1445,398,397,1,2018
부산경남본부,창원지사,가락영업소,1897,506,495,11,2018
부산경남본부,창원지사,동창원영업소,742,197,184,13,2018
부산경남본부,창원지사,마산영업소,2500,576,575,1,2018
부산경남본부,창원지사,북창원영업소,1412,454,436,18,2018
부산경남본부,창원지사,산인영업소,4597,1419,1390,29,2018
부산경남본부,창원지사,서부산영업소,2209,741,705,36,2018
부산경남본부,창원지사,장유영업소,4096,1310,1287,23,2018
부산경남본부,창원지사,진례영업소,1953,603,594,9,2018
부산경남본부,창원지사,창원지사 교통안전팀,2913,971,971,0,2018
수도권본부,경기광주지사,경기광주영업소,450,158,147,11,2018
수도권본부,경기광주지사,곤지암영업소,232,86,78,8,2018
수도권본부,경기광주지사,동서울영업소,3155,1172,914,258,2018
수도권본부,경기광주지사,서이천영업소,349,111,103,8,2018
수도권본부,경기광주지사,하남영업소,513,220,173,47,2018
수도권본부,군포지사,군자영업소,6815,2291,2184,107,2018
수도권본부,군포지사,군포영업소,160,56,50,6,2018
수도권본부,군포지사,군포지사 교통안전팀,544,136,136,0,2018
수도권본부,군포지사,동군포영업소,128,44,42,2,2018
수도권본부,군포지사,동수원영업소,347,99,91,8,2018
수도권본부,군포지사,마성영업소,54,26,20,6,2018
수도권본부,군포지사,부곡영업소,714,235,234,1,2018
수도권본부,군포지사,북수원영업소,293,139,108,31,2018
수도권본부,군포지사,서안산영업소,600,193,187,6,2018
수도권본부,군포지사,안산영업소,507,89,84,5,2018
수도권본부,동서울지사,구리남양주영업소,5552,802,703,99,2018
수도권본부,동서울지사,성남영업소,3683,774,709,65,2018
수도권본부,동서울지사,청계영업소,3844,853,833,20,2018
수도권본부,동서울지사,토평영업소,248,88,84,4,2018
수도권본부,수도권본부 기술처,수도권본부 교통팀,134,36,36,0,2018
수도권본부,수원지사,기흥동탄영업소,821,234,228,6,2018
수도권본부,수원지사,기흥영업소,1318,412,406,6,2018
수도권본부,수원지사,남사진위영업소,227,41,38,3,2018
수도권본부,수원지사,서울영업소,7890,2239,2229,10,2018
수도권본부,수원지사,수원신갈영업소,1508,352,338,14,2018
수도권본부,수원지사,오산영업소,1153,344,340,4,2018
수도권본부,수원지사,판교영업소,160,85,60,25,2018
수도권본부,시흥지사,남인천영업소,3842,1291,1142,149,2018
수도권본부,시흥지사,서서울영업소,2383,1453,927,526,2018
수도권본부,시흥지사,시흥영업소,4545,1251,1214,37,2018
수도권본부,인천지사,김포영업소,8116,2704,2430,274,2018
수도권본부,인천지사,인천영업소,4299,1926,1445,481,2018
수도권본부,인천지사,인천지사 교통안전팀,3665,1219,1219,0,2018
수도권본부,화성지사,남안성영업소,3526,1130,1125,5,2018
수도권본부,화성지사,매송영업소,123,47,41,6,2018
수도권본부,화성지사,발안영업소,1231,385,384,1,2018
수도권본부,화성지사,비봉영업소,393,132,123,9,2018
수도권본부,화성지사,서안성영업소,2486,803,802,1,2018
수도권본부,화성지사,서평택영업소,3928,1129,1078,51,2018
수도권본부,화성지사,송탄영업소,859,249,233,16,2018
수도권본부,화성지사,청북영업소,1641,476,462,14,2018
수도권본부,화성지사,평택고덕영업소,883,277,269,8,2018
수도권본부,화성지사,평택영업소,3581,1064,1022,42,2018
전북본부,논산지사,계룡영업소,318,102,102,0,2018
전북본부,논산지사,논산영업소,418,132,132,0,2018
전북본부,논산지사,완주영업소,809,243,242,1,2018
전북본부,논산지사,익산영업소,678,206,202,4,2018
전북본부,무주지사,금산영업소,502,157,156,1,2018
전북본부,무주지사,남대전영업소,695,204,198,6,2018
전북본부,무주지사,덕유산영업소,91,30,30,0,2018
전북본부,무주지사,무주영업소,383,113,112,1,2018
전북본부,무주지사,추부영업소,331,95,92,3,2018
전북본부,보령지사,광천영업소,562,168,167,1,2018
전북본부,보령지사,군산영업소,338,90,90,0,2018
전북본부,보령지사,대천영업소,393,111,111,0,2018
전북본부,보령지사,무창포영업소,249,75,75,0,2018
전북본부,보령지사,서천영업소,531,169,169,0,2018
전북본부,보령지사,춘장대영업소,83,26,26,0,2018
전북본부,부안지사,고창영업소,448,139,139,0,2018
전북본부,부안지사,동군산영업소,560,170,169,1,2018
전북본부,부안지사,부안영업소,198,63,63,0,2018
전북본부,부안지사,서김제영업소,312,97,97,0,2018
전북본부,부안지사,선운산영업소,479,157,150,7,2018
전북본부,부안지사,줄포영업소,158,47,47,0,2018
전북본부,전주지사,금산사영업소,212,73,71,2,2018
전북본부,전주지사,김제영업소,548,165,164,1,2018
전북본부,전주지사,내장산영업소,236,66,66,0,2018
전북본부,전주지사,삼례영업소,347,113,112,1,2018
전북본부,전주지사,서전주영업소,429,132,132,0,2018
전북본부,전주지사,전주영업소,611,181,181,0,2018
전북본부,전주지사,전주지사 교통안전팀,3,1,1,0,2018
전북본부,전주지사,정읍영업소,283,85,84,1,2018
전북본부,전주지사,태인영업소,360,59,59,0,2018
전북본부,진안지사,동전주영업소,315,97,97,0,2018
전북본부,진안지사,상관영업소,339,105,105,0,2018
전북본부,진안지사,소양영업소,631,206,205,1,2018
전북본부,진안지사,장수영업소,145,34,34,0,2018
전북본부,진안지사,진안영업소,162,54,53,1,2018
지역본부,강원본부,대관령지사,3,1,1,0,2018
지역본부,강원본부,이천지사,3,1,1,0,2018
지역본부,광주전남본부,광주지사,3,1,1,0,2018
지역본부,광주전남본부,담양지사,9,3,3,0,2018
지역본부,대구경북본부,군위지사,15,5,5,0,2018
지역본부,대구경북본부,대구지사,6,2,1,1,2018
지역본부,대구경북본부,성주지사,3,1,1,0,2018
지역본부,대전충남본부,당진지사,5,3,2,1,2018
지역본부,대전충남본부,영동지사,3,1,1,0,2018
지역본부,부산경남본부,경주지사,6,2,2,0,2018
지역본부,부산경남본부,서울산지사,3,1,1,0,2018
지역본부,부산경남본부,울산지사,4,1,1,0,2018
지역본부,수도권본부,시흥지사,3,1,1,0,2018
지역본부,수도권본부,화성지사,3,1,1,0,2018
지역본부,전북본부,전주지사,12,0,0,0,2018
지역본부,전북본부,진안지사,4,0,0,0,2018
충북본부,보은지사,남상주영업소,233,64,64,0,2018
충북본부,보은지사,보은영업소,62,19,19,0,2018
충북본부,보은지사,보은지사 문의청남대영업소,246,77,74,3,2018
충북본부,보은지사,속리산영업소,111,33,31,2,2018
충북본부,보은지사,화서영업소,75,18,18,0,2018
충북본부,보은지사,회인영업소,165,55,55,0,2018
충북본부,상주지사,문경새재영업소,407,112,111,1,2018
충북본부,상주지사,북상주영업소,377,106,106,0,2018
충북본부,상주지사,상주영업소,204,62,61,1,2018
충북본부,상주지사,상주지사 고객지원팀,3,1,1,0,2018
충북본부,상주지사,점촌함창영업소,279,82,79,3,2018
충북본부,엄정지사,금왕꽃동네영업소,320,128,106,22,2018
충북본부,엄정지사,동충주영업소,807,266,263,3,2018
충북본부,엄정지사,북진천영업소,434,116,114,2,2018
충북본부,엄정지사,서충주영업소,458,154,151,3,2018
충북본부,엄정지사,엄정지사 교통안전팀,27,9,9,0,2018
충북본부,엄정지사,음성영업소,377,119,112,7,2018
충북본부,제천지사,남원주영업소,1260,416,410,6,2018
충북본부,제천지사,남제천영업소,965,291,259,32,2018
충북본부,제천지사,단양영업소,191,54,51,3,2018
충북본부,제천지사,북단양영업소,376,107,101,6,2018
충북본부,제천지사,신림영업소,634,238,215,23,2018
충북본부,제천지사,제천영업소,1049,343,332,11,2018
충북본부,제천지사,제천지사 교통안전팀,582,194,194,0,2018
충북본부,진천지사,남이천영업소,339,123,111,12,2018
충북본부,진천지사,대소영업소,356,113,113,0,2018
충북본부,진천지사,서청주영업소,982,263,262,1,2018
충북본부,진천지사,오창영업소,672,176,175,1,2018
충북본부,진천지사,일죽영업소,301,78,77,1,2018
충북본부,진천지사,증평영업소,219,65,64,1,2018
충북본부,진천지사,진천영업소,321,92,92,0,2018
충북본부,진천지사,진천지사 교통안전팀,3246,1138,1096,42,2018
충북본부,충주지사,감곡영업소,154,43,42,1,2018
충북본부,충주지사,괴산영업소,247,66,66,0,2018
충북본부,충주지사,북충주영업소,199,53,51,2,2018
충북본부,충주지사,연풍영업소,368,94,92,2,2018
충북본부,충주지사,충주영업소,178,48,46,2,2018
